Zeit;Fahrradbruecke;Fahrradbruecke stadteinwaerts;Fahrradbruecke stadtauswaerts;Symbol Wetter;Temperatur (°C);Gef�hlte Temperatur (°C);Regen (mm)
08.08.2018 00:00;111;37;74;Leicht bewoelkt;21;21;0
08.08.2018 01:00;49;9;40;Leicht bewoelkt;20;20;0
08.08.2018 02:00;25;9;16;Leicht bewoelkt;20;20;0
08.08.2018 03:00;11;2;9;Leicht bewoelkt;19;19;0
08.08.2018 04:00;9;6;3;Leicht bewoelkt;20;20;0
08.08.2018 05:00;41;24;17;Leicht bewoelkt;20;20;0
08.08.2018 06:00;127;81;46;Leicht bewoelkt;20;20;0
08.08.2018 07:00;271;135;136;Leicht bewoelkt;21;21;0
08.08.2018 08:00;450;238;212;Stellenweiser Regenfall;23;23;0
08.08.2018 09:00;423;246;177;Stellenweiser Regenfall;24;25;0
08.08.2018 10:00;328;187;141;Stellenweiser Regenfall;25;26;0
08.08.2018 11:00;395;204;191;Leicht bewoelkt;27;27;0
08.08.2018 12:00;521;261;260;Leicht bewoelkt;28;29;0
08.08.2018 13:00;466;236;230;Leicht bewoelkt;28;29;0
08.08.2018 14:00;575;271;304;Leicht bewoelkt;29;30;0
08.08.2018 15:00;593;280;313;Leicht bewoelkt;29;31;0
08.08.2018 16:00;766;359;407;Leicht bewoelkt;29;30;0
08.08.2018 17:00;774;373;401;Stellenweise Gewitter und Niederschlaege;28;30;0
08.08.2018 18:00;743;340;403;Stellenweise Gewitter und Niederschlaege;28;30;0
08.08.2018 19:00;617;316;301;Stellenweise Gewitter und Niederschlaege;26;29;0
08.08.2018 20:00;474;235;239;Leichter Regenschauer;25;28;0
08.08.2018 21:00;357;166;191;Leichter Regenschauer;24;28;0
08.08.2018 22:00;330;111;219;Leichter Regenschauer;22;25;0
08.08.2018 23:00;251;69;182;Stellenweiser Regenfall;21;21;0
09.08.2018 00:00;146;22;124;Stellenweiser Regenfall;20;20;0
09.08.2018 01:00;63;22;41;Stellenweiser Regenfall;19;19;0
09.08.2018 02:00;26;9;17;Leicht bewoelkt;18;18;0
09.08.2018 03:00;11;7;4;Leicht bewoelkt;18;18;0
09.08.2018 04:00;9;3;6;Leicht bewoelkt;18;18;0
09.08.2018 05:00;47;25;22;Leicht bewoelkt;19;19;0
09.08.2018 06:00;140;88;52;Leicht bewoelkt;19;19;0
09.08.2018 07:00;351;185;166;Leicht bewoelkt;21;21;0
09.08.2018 08:00;549;299;250;Bewoelkt;22;22;0
09.08.2018 09:00;532;311;221;Bewoelkt;23;24;0
09.08.2018 10:00;449;236;213;Bewoelkt;25;27;0
09.08.2018 11:00;528;231;297;Bedeckt;28;30;0
09.08.2018 12:00;607;256;351;Bedeckt;30;32;0
09.08.2018 13:00;543;253;290;Bedeckt;31;32;0
09.08.2018 14:00;519;234;285;Sonnig;31;32;0
09.08.2018 15:00;639;319;320;Sonnig;31;33;0
09.08.2018 16:00;755;346;409;Sonnig;30;32;1
09.08.2018 17:00;832;357;475;Leicht bewoelkt;29;31;1
09.08.2018 18:00;597;246;351;Leicht bewoelkt;28;30;2
09.08.2018 19:00;422;208;214;Leicht bewoelkt;26;29;1
09.08.2018 20:00;272;129;143;Teilweise maessiger Regenfall;25;28;1
09.08.2018 21:00;201;80;121;Teilweise maessiger Regenfall;24;27;1
09.08.2018 22:00;205;97;108;Teilweise maessiger Regenfall;22;25;1
09.08.2018 23:00;144;56;88;Stellenweiser leichter Regenfall;21;21;0
10.08.2018 00:00;99;20;79;Stellenweiser leichter Regenfall;19;19;0
10.08.2018 01:00;45;8;37;Stellenweiser leichter Regenfall;19;19;0
10.08.2018 02:00;22;11;11;Bewoelkt;18;18;0
10.08.2018 03:00;6;5;1;Bewoelkt;17;17;1
10.08.2018 04:00;3;2;1;Bewoelkt;17;17;1
10.08.2018 05:00;32;12;20;Teilweise maessiger Regenfall;17;17;1
10.08.2018 06:00;114;73;41;Teilweise maessiger Regenfall;16;16;1
10.08.2018 07:00;199;107;92;Teilweise maessiger Regenfall;16;16;1
10.08.2018 08:00;347;201;146;Teilweise maessiger Regenfall;16;16;1
10.08.2018 09:00;363;224;139;Teilweise maessiger Regenfall;16;16;1
10.08.2018 10:00;441;251;190;Teilweise maessiger Regenfall;17;17;0
10.08.2018 11:00;490;270;220;Stellenweiser Nieselregen;17;17;0
10.08.2018 12:00;499;244;255;Stellenweiser Nieselregen;17;17;0
10.08.2018 13:00;528;247;281;Stellenweiser Nieselregen;18;18;0
10.08.2018 14:00;566;280;286;Stellenweiser Nieselregen;18;18;0
10.08.2018 15:00;597;282;315;Stellenweiser Nieselregen;19;19;0
10.08.2018 16:00;737;344;393;Stellenweiser Nieselregen;19;19;0
10.08.2018 17:00;657;326;331;Leicht bewoelkt;19;19;0
10.08.2018 18:00;651;307;344;Leicht bewoelkt;19;19;0
10.08.2018 19:00;547;265;282;Leicht bewoelkt;18;18;0
10.08.2018 20:00;467;242;225;Leicht bewoelkt;17;17;0
10.08.2018 21:00;375;219;156;Leicht bewoelkt;16;16;0
10.08.2018 22:00;293;89;204;Leicht bewoelkt;15;16;0
10.08.2018 23:00;246;55;191;Leicht bewoelkt;15;15;0
11.08.2018 00:00;234;40;194;Leicht bewoelkt;14;14;0
11.08.2018 01:00;110;16;94;Leicht bewoelkt;14;14;0
11.08.2018 02:00;67;18;49;Leicht bewoelkt;14;14;0
11.08.2018 03:00;54;23;31;Leicht bewoelkt;13;14;0
11.08.2018 04:00;27;11;16;Leicht bewoelkt;14;14;0
11.08.2018 05:00;28;17;11;Leicht bewoelkt;15;15;0
11.08.2018 06:00;68;42;26;Leicht bewoelkt;15;15;0
11.08.2018 07:00;92;47;45;Leicht bewoelkt;17;17;0
11.08.2018 08:00;209;116;93;Leicht bewoelkt;18;18;0
11.08.2018 09:00;365;232;133;Leicht bewoelkt;19;19;0
11.08.2018 10:00;530;294;236;Leicht bewoelkt;20;20;0
11.08.2018 11:00;638;329;309;Leicht bewoelkt;21;21;0
11.08.2018 12:00;615;329;286;Leicht bewoelkt;22;23;0
11.08.2018 13:00;750;328;422;Leicht bewoelkt;23;24;0
11.08.2018 14:00;951;349;602;Leicht bewoelkt;23;24;0
11.08.2018 15:00;965;379;586;Leicht bewoelkt;24;25;0
11.08.2018 16:00;925;340;585;Leicht bewoelkt;23;24;0
11.08.2018 17:00;987;466;521;Leicht bewoelkt;22;23;0
11.08.2018 18:00;936;452;484;Leicht bewoelkt;21;21;0
11.08.2018 19:00;834;401;433;Leicht bewoelkt;20;20;0
11.08.2018 20:00;725;355;370;Leicht bewoelkt;18;18;0
11.08.2018 21:00;593;260;333;Leicht bewoelkt;17;17;0
11.08.2018 22:00;279;147;132;Leicht bewoelkt;16;16;0
11.08.2018 23:00;931;483;448;Leicht bewoelkt;15;16;0
12.08.2018 00:00;499;214;285;Leicht bewoelkt;15;15;0
12.08.2018 01:00;284;83;201;Leicht bewoelkt;14;15;0
12.08.2018 02:00;168;41;127;Leicht bewoelkt;14;15;0
12.08.2018 03:00;110;41;69;Leicht bewoelkt;14;15;0
12.08.2018 04:00;34;18;16;Leicht bewoelkt;15;15;0
12.08.2018 05:00;34;19;15;Leicht bewoelkt;15;15;0
12.08.2018 06:00;30;12;18;Leicht bewoelkt;16;16;0
12.08.2018 07:00;58;32;26;Leicht bewoelkt;17;18;0
12.08.2018 08:00;86;45;41;Leicht bewoelkt;19;19;0
12.08.2018 09:00;236;128;108;Leicht bewoelkt;21;21;0
12.08.2018 10:00;279;138;141;Leicht bewoelkt;23;24;0
12.08.2018 11:00;405;201;204;Leicht bewoelkt;24;25;0
12.08.2018 12:00;435;204;231;Leicht bewoelkt;26;27;0
12.08.2018 13:00;517;238;279;Leicht bewoelkt;27;28;0
12.08.2018 14:00;512;233;279;Leicht bewoelkt;28;28;0
12.08.2018 15:00;503;229;274;Leicht bewoelkt;28;29;0
12.08.2018 16:00;500;262;238;Leicht bewoelkt;28;29;0
12.08.2018 17:00;514;248;266;Leicht bewoelkt;28;30;0
12.08.2018 18:00;519;274;245;Leicht bewoelkt;27;30;0
12.08.2018 19:00;489;233;256;Leicht bewoelkt;26;29;0
12.08.2018 20:00;429;221;208;Leicht bewoelkt;25;28;0
12.08.2018 21:00;290;106;184;Leicht bewoelkt;24;27;0
12.08.2018 22:00;198;86;112;Leicht bewoelkt;22;25;0
12.08.2018 23:00;104;47;57;Leicht bewoelkt;21;21;0
13.08.2018 00:00;65;25;40;Leicht bewoelkt;19;19;0
13.08.2018 01:00;36;18;18;Leicht bewoelkt;19;19;0
13.08.2018 02:00;18;9;9;Leicht bewoelkt;18;18;0
13.08.2018 03:00;2;1;1;Leicht bewoelkt;18;18;0
13.08.2018 04:00;7;4;3;Leicht bewoelkt;18;18;0
13.08.2018 05:00;44;23;21;Leicht bewoelkt;18;18;0
13.08.2018 06:00;142;96;46;Leicht bewoelkt;18;18;0
13.08.2018 07:00;331;189;142;Leicht bewoelkt;20;20;0
13.08.2018 08:00;429;253;176;Leicht bewoelkt;22;22;0
13.08.2018 09:00;454;249;205;Leicht bewoelkt;23;24;0
13.08.2018 10:00;540;273;267;Leicht bewoelkt;24;25;0
13.08.2018 11:00;559;287;272;Leicht bewoelkt;24;25;0
13.08.2018 12:00;622;272;350;Leicht bewoelkt;25;26;0
13.08.2018 13:00;459;219;240;Leicht bewoelkt;24;26;0
13.08.2018 14:00;387;189;198;Leicht bewoelkt;24;25;0
13.08.2018 15:00;437;211;226;Leicht bewoelkt;23;25;0
13.08.2018 16:00;548;252;296;Leicht bewoelkt;22;24;0
13.08.2018 17:00;610;285;325;Leichter Regenschauer;21;21;0
13.08.2018 18:00;548;257;291;Leichter Regenschauer;20;20;0
13.08.2018 19:00;397;193;204;Leichter Regenschauer;19;19;0
13.08.2018 20:00;281;111;170;Leicht bewoelkt;19;19;0
13.08.2018 21:00;206;87;119;Leicht bewoelkt;18;18;1
13.08.2018 22:00;136;66;70;Leicht bewoelkt;17;17;1
13.08.2018 23:00;75;27;48;Maessiger bis starker Regenschauer;17;17;0
14.08.2018 00:00;39;15;24;Maessiger bis starker Regenschauer;16;16;0
14.08.2018 01:00;21;10;11;Maessiger bis starker Regenschauer;16;16;0
14.08.2018 02:00;24;6;18;Stellenweiser Regenfall;15;15;0
14.08.2018 03:00;9;4;5;Stellenweiser Regenfall;15;15;0
14.08.2018 04:00;12;7;5;Stellenweiser Regenfall;15;15;0
14.08.2018 05:00;24;9;15;Leichter Regenschauer;16;16;0
14.08.2018 06:00;123;87;36;Leichter Regenschauer;16;16;0
14.08.2018 07:00;287;155;132;Leichter Regenschauer;17;17;0
14.08.2018 08:00;421;245;176;Leichter Regenschauer;18;18;0
14.08.2018 09:00;436;263;173;Leichter Regenschauer;18;18;0
14.08.2018 10:00;415;219;196;Leichter Regenschauer;19;19;1
14.08.2018 11:00;523;274;249;Stellenweiser Regenfall;20;20;1
14.08.2018 12:00;501;238;263;Stellenweiser Regenfall;20;20;1
14.08.2018 13:00;412;170;242;Stellenweiser Regenfall;20;20;1
14.08.2018 14:00;463;231;232;Maessiger bis starker Regenschauer;21;21;1
14.08.2018 15:00;558;285;273;Maessiger bis starker Regenschauer;21;21;1
14.08.2018 16:00;653;323;330;Maessiger bis starker Regenschauer;20;20;1
14.08.2018 17:00;791;361;430;Maessiger bis starker Regenschauer;19;19;1
14.08.2018 18:00;744;296;448;Maessiger bis starker Regenschauer;19;19;1
14.08.2018 19:00;537;237;300;Maessiger bis starker Regenschauer;18;18;1
14.08.2018 20:00;351;176;175;Maessiger bis starker Regenschauer;17;17;1
14.08.2018 21:00;247;109;138;Maessiger bis starker Regenschauer;16;16;0
14.08.2018 22:00;202;73;129;Maessiger bis starker Regenschauer;16;16;0
14.08.2018 23:00;127;50;77;Stellenweiser Regenfall;15;15;0
15.08.2018 00:00;67;25;42;Stellenweiser Regenfall;15;15;0
15.08.2018 01:00;44;16;28;Stellenweiser Regenfall;14;15;0
15.08.2018 02:00;33;11;22;Stellenweiser Regenfall;14;14;0
15.08.2018 03:00;12;5;7;Stellenweiser Regenfall;14;14;0
15.08.2018 04:00;7;5;2;Stellenweiser Regenfall;14;15;0
15.08.2018 05:00;42;22;20;Leicht bewoelkt;15;15;0
15.08.2018 06:00;135;88;47;Leicht bewoelkt;16;16;0
15.08.2018 07:00;322;173;149;Leicht bewoelkt;17;17;0
15.08.2018 08:00;431;266;165;Leicht bewoelkt;19;19;0
15.08.2018 09:00;532;292;240;Leicht bewoelkt;21;21;0
15.08.2018 10:00;509;253;256;Leicht bewoelkt;22;22;0
15.08.2018 11:00;584;328;256;Leicht bewoelkt;23;25;0
15.08.2018 12:00;645;305;340;Leicht bewoelkt;25;26;0
15.08.2018 13:00;547;260;287;Leicht bewoelkt;25;26;0
15.08.2018 14:00;626;305;321;Leicht bewoelkt;25;26;0
15.08.2018 15:00;662;305;357;Leicht bewoelkt;26;26;0
15.08.2018 16:00;730;371;359;Leicht bewoelkt;24;25;0
15.08.2018 17:00;888;419;469;Leicht bewoelkt;23;24;0
15.08.2018 18:00;772;331;441;Leicht bewoelkt;22;23;0
15.08.2018 19:00;616;310;306;Leicht bewoelkt;21;21;0
15.08.2018 20:00;462;215;247;Leicht bewoelkt;20;20;0
15.08.2018 21:00;343;144;199;Leicht bewoelkt;18;18;0
15.08.2018 22:00;310;98;212;Leicht bewoelkt;18;18;0
15.08.2018 23:00;172;52;120;Leicht bewoelkt;17;17;0
16.08.2018 00:00;103;29;74;Leicht bewoelkt;16;16;0
16.08.2018 01:00;47;10;37;Leicht bewoelkt;16;16;0
16.08.2018 02:00;16;10;6;Leicht bewoelkt;16;16;0
16.08.2018 03:00;13;4;9;Leicht bewoelkt;16;16;0
16.08.2018 04:00;13;4;9;Leicht bewoelkt;16;16;0
16.08.2018 05:00;47;27;20;Leicht bewoelkt;17;17;0
16.08.2018 06:00;143;94;49;Leicht bewoelkt;17;17;0
16.08.2018 07:00;315;171;144;Leicht bewoelkt;19;19;0
16.08.2018 08:00;464;278;186;Leicht bewoelkt;21;21;0
16.08.2018 09:00;416;250;166;Leicht bewoelkt;23;23;0
16.08.2018 10:00;498;268;230;Leicht bewoelkt;24;25;0
16.08.2018 11:00;501;238;263;Leicht bewoelkt;25;26;0
16.08.2018 12:00;519;252;267;Leicht bewoelkt;27;27;0
16.08.2018 13:00;545;259;286;Leicht bewoelkt;27;27;0
16.08.2018 14:00;551;271;280;Leicht bewoelkt;27;28;0
16.08.2018 15:00;614;251;363;Leicht bewoelkt;27;28;0
16.08.2018 16:00;678;336;342;Leicht bewoelkt;26;27;0
16.08.2018 17:00;835;391;444;Leicht bewoelkt;25;26;0
16.08.2018 18:00;819;317;502;Leicht bewoelkt;24;26;0
16.08.2018 19:00;669;262;407;Leicht bewoelkt;22;24;0
16.08.2018 20:00;484;195;289;Leicht bewoelkt;21;21;0
16.08.2018 21:00;339;151;188;Leicht bewoelkt;20;20;0
16.08.2018 22:00;321;150;171;Leicht bewoelkt;19;19;0
16.08.2018 23:00;236;148;88;Leicht bewoelkt;19;19;0
17.08.2018 00:00;159;97;62;Leicht bewoelkt;19;19;0
17.08.2018 01:00;74;35;39;Leicht bewoelkt;18;18;0
17.08.2018 02:00;37;18;19;Sonnig;18;18;0
17.08.2018 03:00;10;4;6;Sonnig;18;18;0
17.08.2018 04:00;9;8;1;Sonnig;18;18;0
17.08.2018 05:00;41;19;22;Leicht bewoelkt;18;18;0
17.08.2018 06:00;114;74;40;Leicht bewoelkt;19;19;0
17.08.2018 07:00;298;151;147;Leicht bewoelkt;20;20;0
17.08.2018 08:00;398;224;174;Leicht bewoelkt;21;21;0
17.08.2018 09:00;511;318;193;Leicht bewoelkt;22;23;0
17.08.2018 10:00;502;262;240;Leicht bewoelkt;24;25;0
17.08.2018 11:00;572;286;286;Leicht bewoelkt;25;26;0
17.08.2018 12:00;581;255;326;Leicht bewoelkt;27;28;0
17.08.2018 13:00;561;257;304;Leicht bewoelkt;27;28;0
17.08.2018 14:00;559;263;296;Leicht bewoelkt;28;29;0
17.08.2018 15:00;555;246;309;Leicht bewoelkt;28;29;0
17.08.2018 16:00;664;327;337;Leicht bewoelkt;28;29;0
17.08.2018 17:00;629;244;385;Leicht bewoelkt;27;30;0
17.08.2018 18:00;365;178;187;Leicht bewoelkt;27;30;0
17.08.2018 19:00;252;123;129;Leicht bewoelkt;26;29;0
17.08.2018 20:00;203;94;109;Leichter Regenschauer;25;28;0
17.08.2018 21:00;156;64;92;Leichter Regenschauer;23;27;0
17.08.2018 22:00;133;52;81;Leichter Regenschauer;22;22;0
17.08.2018 23:00;126;34;92;Stellenweiser Regenfall;20;20;0
18.08.2018 00:00;72;22;50;Stellenweiser Regenfall;19;19;0
18.08.2018 01:00;43;17;26;Stellenweiser Regenfall;18;18;0
18.08.2018 02:00;32;13;19;Leicht bewoelkt;17;17;0
18.08.2018 03:00;29;13;16;Leicht bewoelkt;16;16;0
18.08.2018 04:00;15;7;8;Leicht bewoelkt;16;16;0
18.08.2018 05:00;21;11;10;Leicht bewoelkt;17;17;0
18.08.2018 06:00;36;22;14;Leicht bewoelkt;17;17;0
18.08.2018 07:00;56;36;20;Leicht bewoelkt;18;18;0
18.08.2018 08:00;132;65;67;Leicht bewoelkt;20;20;0
18.08.2018 09:00;286;176;110;Leicht bewoelkt;21;21;0
18.08.2018 10:00;424;220;204;Leicht bewoelkt;22;24;0
18.08.2018 11:00;473;261;212;Leicht bewoelkt;24;25;0
18.08.2018 12:00;495;231;264;Leicht bewoelkt;25;26;0
18.08.2018 13:00;544;249;295;Leicht bewoelkt;25;26;0
18.08.2018 14:00;558;246;312;Leicht bewoelkt;25;26;0
18.08.2018 15:00;497;238;259;Leicht bewoelkt;25;26;0
18.08.2018 16:00;532;224;308;Leicht bewoelkt;24;25;0
18.08.2018 17:00;499;226;273;Stellenweiser Regenfall;23;24;0
18.08.2018 18:00;497;218;279;Stellenweiser Regenfall;22;22;0
18.08.2018 19:00;443;204;239;Stellenweiser Regenfall;21;21;0
18.08.2018 20:00;365;150;215;Leicht bewoelkt;20;20;0
18.08.2018 21:00;245;124;121;Leicht bewoelkt;19;19;0
18.08.2018 22:00;176;82;94;Leicht bewoelkt;18;18;0
18.08.2018 23:00;186;54;132;Stellenweiser Regenfall;17;17;0
19.08.2018 00:00;143;51;92;Stellenweiser Regenfall;17;17;0
19.08.2018 01:00;111;37;74;Stellenweiser Regenfall;16;16;0
19.08.2018 02:00;50;17;33;Leicht bewoelkt;16;16;0
19.08.2018 03:00;28;10;18;Leicht bewoelkt;16;16;0
19.08.2018 04:00;21;11;10;Leicht bewoelkt;16;16;0
19.08.2018 05:00;26;11;15;Leicht bewoelkt;17;17;0
19.08.2018 06:00;26;16;10;Leicht bewoelkt;17;17;0
19.08.2018 07:00;35;15;20;Leicht bewoelkt;19;19;0
19.08.2018 08:00;121;60;61;Leicht bewoelkt;20;20;0
19.08.2018 09:00;244;125;119;Leicht bewoelkt;22;22;0
19.08.2018 10:00;315;163;152;Leicht bewoelkt;23;24;0
19.08.2018 11:00;422;205;217;Leicht bewoelkt;24;26;0
19.08.2018 12:00;387;167;220;Leicht bewoelkt;26;27;0
19.08.2018 13:00;358;157;201;Leicht bewoelkt;26;27;0
19.08.2018 14:00;457;195;262;Leicht bewoelkt;26;28;0
19.08.2018 15:00;427;192;235;Leicht bewoelkt;27;28;0
19.08.2018 16:00;450;230;220;Leicht bewoelkt;26;27;0
19.08.2018 17:00;459;255;204;Leicht bewoelkt;25;26;0
19.08.2018 18:00;498;236;262;Leicht bewoelkt;24;26;0
19.08.2018 19:00;410;224;186;Leicht bewoelkt;22;24;0
19.08.2018 20:00;326;149;177;Stellenweiser Regenfall;21;21;0
19.08.2018 21:00;225;88;137;Stellenweiser Regenfall;20;20;0
19.08.2018 22:00;145;52;93;Stellenweiser Regenfall;19;19;0
19.08.2018 23:00;84;31;53;Stellenweiser Regenfall;19;19;0
20.08.2018 00:00;137;69;68;Stellenweiser Regenfall;18;18;0
20.08.2018 01:00;143;74;69;Stellenweiser Regenfall;18;18;0
20.08.2018 02:00;10;5;5;Stellenweiser Regenfall;17;17;0
20.08.2018 03:00;11;4;7;Stellenweiser Regenfall;17;17;0
20.08.2018 04:00;5;2;3;Stellenweiser Regenfall;17;17;0
20.08.2018 05:00;35;19;16;Leicht bewoelkt;18;18;0
20.08.2018 06:00;127;88;39;Leicht bewoelkt;18;18;0
20.08.2018 07:00;298;154;144;Leicht bewoelkt;19;19;0
20.08.2018 08:00;419;230;189;Leicht bewoelkt;21;21;0
20.08.2018 09:00;442;258;184;Leicht bewoelkt;22;23;0
20.08.2018 10:00;406;220;186;Leicht bewoelkt;24;25;0
20.08.2018 11:00;506;242;264;Leicht bewoelkt;25;26;0
20.08.2018 12:00;464;245;219;Leicht bewoelkt;26;28;0
20.08.2018 13:00;506;249;257;Leicht bewoelkt;26;28;0
20.08.2018 14:00;494;239;255;Leicht bewoelkt;27;28;0
20.08.2018 15:00;597;267;330;Leicht bewoelkt;27;28;0
20.08.2018 16:00;613;299;314;Leicht bewoelkt;26;28;0
20.08.2018 17:00;804;394;410;Leicht bewoelkt;26;27;0
20.08.2018 18:00;708;309;399;Leicht bewoelkt;25;27;0
20.08.2018 19:00;608;272;336;Leicht bewoelkt;25;26;0
20.08.2018 20:00;481;213;268;Stellenweiser Regenfall;24;26;0
20.08.2018 21:00;303;126;177;Stellenweiser Regenfall;23;25;0
20.08.2018 22:00;190;75;115;Stellenweiser Regenfall;21;21;0
20.08.2018 23:00;139;45;94;Leicht bewoelkt;20;20;0
21.08.2018 00:00;82;25;57;Leicht bewoelkt;19;19;0
21.08.2018 01:00;50;15;35;Leicht bewoelkt;18;18;0
21.08.2018 02:00;16;5;11;Leicht bewoelkt;17;17;0
21.08.2018 03:00;6;4;2;Leicht bewoelkt;16;16;0
21.08.2018 04:00;11;6;5;Leicht bewoelkt;17;17;0
21.08.2018 05:00;47;24;23;Leicht bewoelkt;17;17;0
21.08.2018 06:00;149;104;45;Leicht bewoelkt;17;17;0
21.08.2018 07:00;322;160;162;Leicht bewoelkt;19;19;0
21.08.2018 08:00;518;292;226;Leicht bewoelkt;20;20;0
21.08.2018 09:00;495;268;227;Leicht bewoelkt;22;22;0
21.08.2018 10:00;530;286;244;Leicht bewoelkt;23;24;0
21.08.2018 11:00;543;254;289;Leicht bewoelkt;24;25;0
21.08.2018 12:00;515;272;243;Leicht bewoelkt;25;27;0
21.08.2018 13:00;524;223;301;Leicht bewoelkt;26;27;0
21.08.2018 14:00;593;282;311;Leicht bewoelkt;26;27;0
21.08.2018 15:00;591;268;323;Leicht bewoelkt;27;28;0
21.08.2018 16:00;699;330;369;Leicht bewoelkt;26;27;0
21.08.2018 17:00;840;420;420;Leicht bewoelkt;25;26;0
21.08.2018 18:00;795;363;432;Leicht bewoelkt;24;26;0
21.08.2018 19:00;642;278;364;Leicht bewoelkt;23;24;0
21.08.2018 20:00;468;213;255;Leicht bewoelkt;22;22;0
21.08.2018 21:00;352;156;196;Leicht bewoelkt;20;20;0
21.08.2018 22:00;272;88;184;Leicht bewoelkt;20;20;0
21.08.2018 23:00;132;51;81;Leicht bewoelkt;19;19;0
22.08.2018 00:00;83;21;62;Leicht bewoelkt;18;18;0
22.08.2018 01:00;31;11;20;Leicht bewoelkt;18;18;0
22.08.2018 02:00;27;12;15;Leicht bewoelkt;18;18;0
22.08.2018 03:00;7;3;4;Leicht bewoelkt;18;18;0
22.08.2018 04:00;7;5;2;Leicht bewoelkt;18;18;0
22.08.2018 05:00;54;26;28;Leicht bewoelkt;19;19;0
22.08.2018 06:00;134;77;57;Leicht bewoelkt;19;19;0
22.08.2018 07:00;315;183;132;Leicht bewoelkt;21;21;0
22.08.2018 08:00;442;256;186;Leicht bewoelkt;22;23;0
22.08.2018 09:00;490;289;201;Leicht bewoelkt;24;25;0
22.08.2018 10:00;527;271;256;Leicht bewoelkt;25;27;0
22.08.2018 11:00;479;229;250;Leicht bewoelkt;27;28;0
22.08.2018 12:00;530;237;293;Leicht bewoelkt;28;30;0
22.08.2018 13:00;487;211;276;Leicht bewoelkt;28;30;0
22.08.2018 14:00;518;249;269;Leicht bewoelkt;28;30;0
22.08.2018 15:00;570;280;290;Leicht bewoelkt;29;30;0
22.08.2018 16:00;674;341;333;Leicht bewoelkt;28;30;0
22.08.2018 17:00;772;372;400;Stellenweiser Regenfall;28;29;0
22.08.2018 18:00;728;328;400;Stellenweiser Regenfall;27;29;0
22.08.2018 19:00;614;296;318;Stellenweiser Regenfall;26;29;0
22.08.2018 20:00;507;235;272;Stellenweiser Regenfall;26;29;0
22.08.2018 21:00;328;130;198;Stellenweiser Regenfall;25;28;0
22.08.2018 22:00;260;87;173;Stellenweiser Regenfall;23;26;0
22.08.2018 23:00;184;62;122;Stellenweiser Regenfall;22;22;0
23.08.2018 00:00;90;33;57;Stellenweiser Regenfall;20;20;0
23.08.2018 01:00;63;23;40;Stellenweiser Regenfall;19;19;0
23.08.2018 02:00;26;9;17;Stellenweiser Regenfall;19;19;0
23.08.2018 03:00;12;4;8;Stellenweiser Regenfall;18;18;0
23.08.2018 04:00;24;14;10;Stellenweiser Regenfall;18;18;0
23.08.2018 05:00;51;26;25;Stellenweiser Regenfall;18;18;0
23.08.2018 06:00;124;76;48;Stellenweiser Regenfall;18;18;0
23.08.2018 07:00;301;166;135;Stellenweiser Regenfall;20;20;0
23.08.2018 08:00;441;234;207;Stellenweiser Regenfall;21;21;0
23.08.2018 09:00;428;265;163;Stellenweiser Regenfall;23;23;0
23.08.2018 10:00;435;222;213;Stellenweiser Regenfall;24;25;0
23.08.2018 11:00;508;263;245;Leicht bewoelkt;25;26;0
23.08.2018 12:00;498;246;252;Leicht bewoelkt;27;28;0
23.08.2018 13:00;520;254;266;Leicht bewoelkt;27;28;0
23.08.2018 14:00;515;250;265;Leicht bewoelkt;28;29;0
23.08.2018 15:00;590;255;335;Leicht bewoelkt;28;29;0
23.08.2018 16:00;474;199;275;Leicht bewoelkt;28;30;0
23.08.2018 17:00;422;188;234;Leicht bewoelkt;27;30;0
23.08.2018 18:00;480;214;266;Leicht bewoelkt;27;30;0
23.08.2018 19:00;380;185;195;Leicht bewoelkt;26;29;0
23.08.2018 20:00;292;135;157;Leicht bewoelkt;25;28;1
23.08.2018 21:00;244;89;155;Leicht bewoelkt;24;27;1
23.08.2018 22:00;174;68;106;Leicht bewoelkt;22;25;1
23.08.2018 23:00;125;45;80;Maessiger bis starker Regenschauer;21;21;1
24.08.2018 00:00;90;39;51;Maessiger bis starker Regenschauer;19;19;1
24.08.2018 01:00;28;14;14;Maessiger bis starker Regenschauer;18;18;1
24.08.2018 02:00;11;8;3;Maessiger bis starker Regenschauer;17;17;1
24.08.2018 03:00;9;6;3;Maessiger bis starker Regenschauer;17;17;0
24.08.2018 04:00;3;0;3;Maessiger bis starker Regenschauer;17;17;0
24.08.2018 05:00;33;16;17;Leicht bewoelkt;17;17;0
24.08.2018 06:00;93;59;34;Leicht bewoelkt;17;17;0
24.08.2018 07:00;216;124;92;Leicht bewoelkt;18;18;0
24.08.2018 08:00;255;155;100;Stellenweiser Regenfall;19;19;0
24.08.2018 09:00;322;205;117;Stellenweiser Regenfall;20;20;0
24.08.2018 10:00;319;182;137;Stellenweiser Regenfall;21;21;0
24.08.2018 11:00;402;211;191;Stellenweiser Regenfall;21;21;0
24.08.2018 12:00;461;204;257;Stellenweiser Regenfall;22;22;0
24.08.2018 13:00;421;196;225;Stellenweiser Regenfall;21;21;0
24.08.2018 14:00;458;229;229;Leicht bewoelkt;21;21;0
24.08.2018 15:00;457;227;230;Leicht bewoelkt;21;21;0
24.08.2018 16:00;531;258;273;Leicht bewoelkt;20;20;1
24.08.2018 17:00;545;241;304;Leichter Regenschauer;19;19;1
24.08.2018 18:00;457;184;273;Leichter Regenschauer;18;18;1
24.08.2018 19:00;364;181;183;Leichter Regenschauer;17;17;1
24.08.2018 20:00;263;124;139;Maessiger bis starker Regenschauer;16;16;1
24.08.2018 21:00;214;103;111;Maessiger bis starker Regenschauer;15;15;1
24.08.2018 22:00;215;83;132;Maessiger bis starker Regenschauer;15;15;1
24.08.2018 23:00;134;47;87;Leichter Regenschauer;14;15;0
25.08.2018 00:00;112;30;82;Leichter Regenschauer;14;14;0
25.08.2018 01:00;74;23;51;Leichter Regenschauer;14;14;0
25.08.2018 02:00;56;16;40;Stellenweiser Regenfall;14;14;0
25.08.2018 03:00;29;16;13;Stellenweiser Regenfall;13;14;0
25.08.2018 04:00;14;7;7;Stellenweiser Regenfall;14;14;0
25.08.2018 05:00;32;13;19;Leicht bewoelkt;14;14;0
25.08.2018 06:00;39;19;20;Leicht bewoelkt;14;14;0
25.08.2018 07:00;71;50;21;Leicht bewoelkt;15;15;0
25.08.2018 08:00;168;70;98;Bewoelkt;15;15;0
25.08.2018 09:00;270;168;102;Bewoelkt;16;16;0
25.08.2018 10:00;364;201;163;Bewoelkt;16;16;0
25.08.2018 11:00;395;192;203;Bewoelkt;17;17;0
25.08.2018 12:00;337;187;150;Bewoelkt;17;17;0
25.08.2018 13:00;325;156;169;Bewoelkt;16;16;0
25.08.2018 14:00;344;148;196;Bedeckt;16;15;0
25.08.2018 15:00;278;114;164;Bedeckt;15;14;0
25.08.2018 16:00;251;108;143;Bedeckt;14;14;0
25.08.2018 17:00;263;126;137;Leichter Regenfall;13;13;0
25.08.2018 18:00;217;99;118;Leichter Regenfall;13;12;1
25.08.2018 19:00;189;76;113;Leichter Regenfall;12;12;1
25.08.2018 20:00;210;94;116;Leichter Regenfall;12;11;1
25.08.2018 21:00;146;65;81;Leichter Regenfall;11;11;1
25.08.2018 22:00;110;54;56;Leichter Regenfall;11;10;1
25.08.2018 23:00;115;50;65;Maessiger Regenfall;10;10;1
26.08.2018 00:00;105;34;71;Maessiger Regenfall;10;10;1
26.08.2018 01:00;72;36;36;Maessiger Regenfall;9;9;1
26.08.2018 02:00;52;22;30;Teilweise maessiger Regenfall;9;9;1
26.08.2018 03:00;47;20;27;Teilweise maessiger Regenfall;8;8;0
26.08.2018 04:00;18;2;16;Teilweise maessiger Regenfall;8;8;0
26.08.2018 05:00;17;10;7;Stellenweiser Regenfall;9;9;0
26.08.2018 06:00;23;11;12;Stellenweiser Regenfall;9;9;0
26.08.2018 07:00;32;15;17;Stellenweiser Regenfall;11;11;0
26.08.2018 08:00;70;32;38;Stellenweiser Regenfall;12;12;0
26.08.2018 09:00;189;109;80;Stellenweiser Regenfall;14;14;0
26.08.2018 10:00;223;107;116;Stellenweiser Regenfall;15;15;0
26.08.2018 11:00;327;152;175;Leicht bewoelkt;17;17;0
26.08.2018 12:00;346;168;178;Leicht bewoelkt;18;18;0
26.08.2018 13:00;353;156;197;Leicht bewoelkt;18;18;0
26.08.2018 14:00;429;212;217;Leicht bewoelkt;19;19;0
26.08.2018 15:00;381;175;206;Leicht bewoelkt;19;19;0
26.08.2018 16:00;378;186;192;Leicht bewoelkt;18;18;0
26.08.2018 17:00;425;183;242;Leicht bewoelkt;18;18;0
26.08.2018 18:00;438;215;223;Leicht bewoelkt;17;17;0
26.08.2018 19:00;317;162;155;Leicht bewoelkt;17;17;0
26.08.2018 20:00;274;139;135;Leicht bewoelkt;16;16;0
26.08.2018 21:00;175;86;89;Leicht bewoelkt;15;15;0
26.08.2018 22:00;104;41;63;Leicht bewoelkt;14;14;0
26.08.2018 23:00;62;31;31;Leicht bewoelkt;13;13;0
27.08.2018 00:00;49;17;32;Leicht bewoelkt;11;11;0
27.08.2018 01:00;10;6;4;Leicht bewoelkt;11;11;0
27.08.2018 02:00;7;3;4;Leicht bewoelkt;10;10;0
27.08.2018 03:00;2;2;0;Leicht bewoelkt;10;10;0
27.08.2018 04:00;4;1;3;Leicht bewoelkt;10;10;0
27.08.2018 05:00;41;24;17;Leicht bewoelkt;11;11;0
27.08.2018 06:00;146;92;54;Leicht bewoelkt;12;12;0
27.08.2018 07:00;318;180;138;Leicht bewoelkt;13;14;0
27.08.2018 08:00;441;243;198;Leicht bewoelkt;15;15;0
27.08.2018 09:00;373;214;159;Leicht bewoelkt;16;17;0
27.08.2018 10:00;418;214;204;Leicht bewoelkt;18;18;0
27.08.2018 11:00;463;255;208;Leicht bewoelkt;19;19;0
27.08.2018 12:00;475;231;244;Leicht bewoelkt;21;21;0
27.08.2018 13:00;493;235;258;Leicht bewoelkt;21;21;0
27.08.2018 14:00;500;260;240;Leicht bewoelkt;22;22;0
27.08.2018 15:00;584;291;293;Leicht bewoelkt;22;24;0
27.08.2018 16:00;698;350;348;Leicht bewoelkt;21;21;0
27.08.2018 17:00;688;296;392;Leicht bewoelkt;20;20;0
27.08.2018 18:00;611;242;369;Leicht bewoelkt;20;20;0
27.08.2018 19:00;450;193;257;Leicht bewoelkt;18;18;0
27.08.2018 20:00;345;144;201;Bewoelkt;16;16;0
27.08.2018 21:00;253;114;139;Bewoelkt;15;15;0
27.08.2018 22:00;166;72;94;Bewoelkt;15;15;0
27.08.2018 23:00;104;51;53;Leicht bewoelkt;15;15;0
28.08.2018 00:00;68;35;33;Leicht bewoelkt;15;15;0
28.08.2018 01:00;38;10;28;Leicht bewoelkt;16;16;0
28.08.2018 02:00;11;4;7;Bewoelkt;16;16;0
28.08.2018 03:00;14;6;8;Bewoelkt;16;16;0
28.08.2018 04:00;5;2;3;Bewoelkt;16;16;0
28.08.2018 05:00;43;26;17;Leicht bewoelkt;17;17;0
28.08.2018 06:00;138;89;49;Leicht bewoelkt;17;17;0
28.08.2018 07:00;341;186;155;Leicht bewoelkt;18;18;0
28.08.2018 08:00;523;286;237;Leicht bewoelkt;20;20;0
28.08.2018 09:00;487;263;224;Leicht bewoelkt;22;22;0
28.08.2018 10:00;513;250;263;Leicht bewoelkt;23;24;0
28.08.2018 11:00;534;237;297;Leicht bewoelkt;24;25;0
28.08.2018 12:00;480;203;277;Leicht bewoelkt;26;27;0
28.08.2018 13:00;523;238;285;Leicht bewoelkt;26;27;0
28.08.2018 14:00;614;304;310;Leicht bewoelkt;26;27;0
28.08.2018 15:00;590;272;318;Leicht bewoelkt;27;28;0
28.08.2018 16:00;774;368;406;Leicht bewoelkt;26;27;0
28.08.2018 17:00;841;404;437;Sonnig;25;27;0
28.08.2018 18:00;762;334;428;Sonnig;24;27;0
28.08.2018 19:00;549;230;319;Sonnig;23;26;0
28.08.2018 20:00;411;148;263;Leicht bewoelkt;22;25;0
28.08.2018 21:00;284;129;155;Leicht bewoelkt;22;22;0
28.08.2018 22:00;216;81;135;Leicht bewoelkt;20;20;0
28.08.2018 23:00;116;42;74;Leicht bewoelkt;19;19;0
29.08.2018 00:00;84;33;51;Leicht bewoelkt;18;18;0
29.08.2018 01:00;104;51;53;Leicht bewoelkt;18;18;0
29.08.2018 02:00;17;11;6;Leicht bewoelkt;17;17;0
29.08.2018 03:00;9;4;5;Leicht bewoelkt;16;16;0
29.08.2018 04:00;8;5;3;Leicht bewoelkt;17;17;0
29.08.2018 05:00;49;25;24;Leicht bewoelkt;17;17;0
29.08.2018 06:00;141;88;53;Leicht bewoelkt;17;17;0
29.08.2018 07:00;341;180;161;Leicht bewoelkt;19;19;0
29.08.2018 08:00;505;270;235;Leicht bewoelkt;20;20;0
29.08.2018 09:00;437;253;184;Leicht bewoelkt;22;23;0
29.08.2018 10:00;456;229;227;Leicht bewoelkt;23;24;0
29.08.2018 11:00;493;252;241;Leicht bewoelkt;25;26;0
29.08.2018 12:00;504;204;300;Leicht bewoelkt;26;27;0
29.08.2018 13:00;514;244;270;Leicht bewoelkt;26;27;0
29.08.2018 14:00;601;293;308;Leicht bewoelkt;26;27;0
29.08.2018 15:00;616;306;310;Leicht bewoelkt;26;27;0
29.08.2018 16:00;682;332;350;Leicht bewoelkt;25;27;0
29.08.2018 17:00;862;377;485;Stellenweise Gewitter und Niederschlaege;24;26;0
29.08.2018 18:00;586;266;320;Stellenweise Gewitter und Niederschlaege;23;25;0
29.08.2018 19:00;204;79;125;Stellenweise Gewitter und Niederschlaege;22;22;0
29.08.2018 20:00;229;100;129;Nieselregen;20;20;0
29.08.2018 21:00;151;74;77;Nieselregen;19;19;1
29.08.2018 22:00;135;49;86;Nieselregen;18;18;1
29.08.2018 23:00;71;29;42;Teilweise maessiger Regenfall;18;18;0
30.08.2018 00:00;49;10;39;Teilweise maessiger Regenfall;17;17;0
30.08.2018 01:00;44;13;31;Teilweise maessiger Regenfall;17;17;0
30.08.2018 02:00;12;8;4;Leicht bewoelkt;17;17;0
30.08.2018 03:00;13;8;5;Leicht bewoelkt;17;17;0
30.08.2018 04:00;8;5;3;Leicht bewoelkt;16;16;0
30.08.2018 05:00;33;15;18;Leichter Regenschauer;16;16;0
30.08.2018 06:00;118;74;44;Leichter Regenschauer;16;16;0
30.08.2018 07:00;254;133;121;Leichter Regenschauer;17;17;0
30.08.2018 08:00;344;191;153;Leichter Regenschauer;17;17;0
30.08.2018 09:00;325;206;119;Leichter Regenschauer;17;17;0
30.08.2018 10:00;306;159;147;Leichter Regenschauer;18;18;0
30.08.2018 11:00;330;159;171;Stellenweiser Regenfall;19;19;0
30.08.2018 12:00;417;213;204;Stellenweiser Regenfall;20;20;0
30.08.2018 13:00;403;201;202;Stellenweiser Regenfall;20;20;0
30.08.2018 14:00;397;192;205;Stellenweiser Regenfall;21;21;0
30.08.2018 15:00;461;237;224;Stellenweiser Regenfall;22;22;0
30.08.2018 16:00;596;307;289;Stellenweiser Regenfall;21;21;0
30.08.2018 17:00;596;287;309;Leicht bewoelkt;21;21;0
30.08.2018 18:00;557;247;310;Leicht bewoelkt;20;20;0
30.08.2018 19:00;428;174;254;Leicht bewoelkt;19;19;0
30.08.2018 20:00;295;121;174;Stellenweiser Regenfall;18;18;0
30.08.2018 21:00;226;89;137;Stellenweiser Regenfall;17;17;0
30.08.2018 22:00;174;75;99;Stellenweiser Regenfall;16;16;0
30.08.2018 23:00;132;45;87;Leicht bewoelkt;15;15;0
31.08.2018 00:00;54;14;40;Leicht bewoelkt;14;14;0
31.08.2018 01:00;41;14;27;Leicht bewoelkt;13;13;0
31.08.2018 02:00;19;8;11;Leicht bewoelkt;13;13;0
31.08.2018 03:00;10;3;7;Leicht bewoelkt;13;12;0
31.08.2018 04:00;7;5;2;Leicht bewoelkt;13;12;0
31.08.2018 05:00;30;15;15;Bedeckt;13;13;0
31.08.2018 06:00;90;56;34;Bedeckt;13;13;0
31.08.2018 07:00;189;95;94;Bedeckt;14;13;0
31.08.2018 08:00;284;154;130;Nieselregen;14;14;1
31.08.2018 09:00;326;222;104;Nieselregen;14;14;1
31.08.2018 10:00;331;194;137;Nieselregen;14;15;1
31.08.2018 11:00;355;182;173;Maessiger Regenfall;15;15;1
31.08.2018 12:00;316;127;189;Maessiger Regenfall;15;15;2
31.08.2018 13:00;268;101;167;Maessiger Regenfall;15;15;2
31.08.2018 14:00;288;141;147;Maessiger Regenfall;15;15;1
31.08.2018 15:00;305;139;166;Maessiger Regenfall;15;15;1
31.08.2018 16:00;327;165;162;Maessiger Regenfall;15;14;1
31.08.2018 17:00;312;145;167;Teilweise maessiger Regenfall;14;14;1
31.08.2018 18:00;223;75;148;Teilweise maessiger Regenfall;14;13;1
31.08.2018 19:00;192;65;127;Teilweise maessiger Regenfall;13;13;0
31.08.2018 20:00;140;73;67;Stellenweiser leichter Regenfall;13;12;0
31.08.2018 21:00;76;29;47;Stellenweiser leichter Regenfall;13;12;0
31.08.2018 22:00;69;34;35;Stellenweiser leichter Regenfall;12;11;0
31.08.2018 23:00;70;26;44;Nieselregen;12;11;0
01.09.2018 00:00;50;15;35;Nieselregen;12;11;0
01.09.2018 01:00;22;7;15;Nieselregen;12;11;0
01.09.2018 02:00;36;8;28;Bedeckt;12;11;0
01.09.2018 03:00;20;5;15;Bedeckt;12;11;0
01.09.2018 04:00;10;4;6;Bedeckt;12;11;0
01.09.2018 05:00;17;8;9;Leichter Regenfall;13;11;1
01.09.2018 06:00;40;26;14;Leichter Regenfall;13;11;1
01.09.2018 07:00;76;26;50;Leichter Regenfall;13;11;1
01.09.2018 08:00;157;53;104;Maessiger Regenfall;13;11;1
01.09.2018 09:00;281;133;148;Maessiger Regenfall;13;11;1
01.09.2018 10:00;235;96;139;Maessiger Regenfall;13;11;0
01.09.2018 11:00;332;154;178;Leichter Regenfall;13;11;0
01.09.2018 12:00;368;162;206;Leichter Regenfall;12;11;0
01.09.2018 13:00;359;161;198;Leichter Regenfall;12;11;0
01.09.2018 14:00;411;153;258;Leichter Regenfall;12;11;0
01.09.2018 15:00;369;140;229;Leichter Regenfall;12;11;0
01.09.2018 16:00;346;129;217;Leichter Regenfall;12;11;0
01.09.2018 17:00;269;111;158;Nieselregen;12;11;0
01.09.2018 18:00;255;93;162;Nieselregen;12;12;0
01.09.2018 19:00;209;95;114;Nieselregen;12;12;0
01.09.2018 20:00;189;84;105;Bedeckt;12;12;0
01.09.2018 21:00;136;56;80;Bedeckt;12;12;0
01.09.2018 22:00;137;63;74;Bedeckt;12;12;0
01.09.2018 23:00;85;35;50;Stellenweiser Regenfall;12;12;0
02.09.2018 00:00;83;31;52;Stellenweiser Regenfall;12;12;0
02.09.2018 01:00;73;26;47;Stellenweiser Regenfall;12;12;0
02.09.2018 02:00;116;37;79;Bedeckt;12;12;0
02.09.2018 03:00;32;17;15;Bedeckt;12;12;0
02.09.2018 04:00;24;13;11;Bedeckt;12;12;0
02.09.2018 05:00;17;10;7;Nieselregen;12;12;0
02.09.2018 06:00;22;11;11;Nieselregen;12;12;0
02.09.2018 07:00;33;22;11;Nieselregen;13;13;0
02.09.2018 08:00;56;28;28;Leichter Nebel;13;13;0
02.09.2018 09:00;141;72;69;Leichter Nebel;14;14;0
02.09.2018 10:00;162;105;57;Leichter Nebel;14;15;0
02.09.2018 11:00;195;110;85;Stellenweiser Regenfall;15;15;0
02.09.2018 12:00;232;109;123;Stellenweiser Regenfall;16;16;0
02.09.2018 13:00;241;110;131;Stellenweiser Regenfall;16;16;0
02.09.2018 14:00;319;146;173;Bedeckt;16;16;0
02.09.2018 15:00;289;140;149;Bedeckt;17;17;0
02.09.2018 16:00;281;123;158;Bedeckt;16;16;0
02.09.2018 17:00;292;149;143;Stellenweiser Regenfall;15;15;0
02.09.2018 18:00;298;150;148;Stellenweiser Regenfall;15;15;0
02.09.2018 19:00;189;93;96;Stellenweiser Regenfall;14;14;0
02.09.2018 20:00;155;65;90;Leicht bewoelkt;13;13;0
02.09.2018 21:00;110;48;62;Leicht bewoelkt;12;13;0
02.09.2018 22:00;82;42;40;Leicht bewoelkt;12;12;0
02.09.2018 23:00;41;11;30;Leichter Nebel;12;12;0
03.09.2018 00:00;30;12;18;Leichter Nebel;12;12;0
03.09.2018 01:00;12;5;7;Leichter Nebel;11;11;0
03.09.2018 02:00;3;1;2;Leichter Nebel;11;11;0
03.09.2018 03:00;4;3;1;Leichter Nebel;11;11;0
03.09.2018 04:00;3;1;2;Leichter Nebel;11;11;0
03.09.2018 05:00;29;18;11;Leichter Nebel;12;11;0
03.09.2018 06:00;133;76;57;Leichter Nebel;12;12;0
03.09.2018 07:00;305;176;129;Leichter Nebel;13;13;0
03.09.2018 08:00;467;244;223;Leicht bewoelkt;15;15;0
03.09.2018 09:00;427;254;173;Leicht bewoelkt;16;16;0
03.09.2018 10:00;392;226;166;Leicht bewoelkt;17;17;0
03.09.2018 11:00;403;188;215;Bewoelkt;19;19;0
03.09.2018 12:00;447;187;260;Bewoelkt;20;20;0
03.09.2018 13:00;448;205;243;Bewoelkt;20;20;0
03.09.2018 14:00;509;249;260;Leicht bewoelkt;21;21;0
03.09.2018 15:00;556;265;291;Leicht bewoelkt;21;21;0
03.09.2018 16:00;628;330;298;Leicht bewoelkt;20;20;0
03.09.2018 17:00;774;368;406;Stellenweiser Regenfall;20;20;0
03.09.2018 18:00;612;273;339;Stellenweiser Regenfall;19;19;0
03.09.2018 19:00;498;193;305;Stellenweiser Regenfall;17;18;0
03.09.2018 20:00;369;153;216;Leicht bewoelkt;16;16;0
03.09.2018 21:00;199;94;105;Leicht bewoelkt;15;15;0
03.09.2018 22:00;176;64;112;Leicht bewoelkt;14;14;0
03.09.2018 23:00;78;45;33;Leicht bewoelkt;13;14;0
04.09.2018 00:00;47;20;27;Leicht bewoelkt;13;13;0
04.09.2018 01:00;19;9;10;Leicht bewoelkt;12;13;0
04.09.2018 02:00;8;4;4;Leicht bewoelkt;12;13;0
04.09.2018 03:00;6;3;3;Leicht bewoelkt;12;13;0
04.09.2018 04:00;7;3;4;Leicht bewoelkt;13;13;0
04.09.2018 05:00;35;22;13;Leicht bewoelkt;13;13;0
04.09.2018 06:00;159;95;64;Leicht bewoelkt;13;14;0
04.09.2018 07:00;353;187;166;Leicht bewoelkt;14;15;0
04.09.2018 08:00;552;303;249;Leicht bewoelkt;16;16;0
04.09.2018 09:00;414;240;174;Leicht bewoelkt;17;17;0
04.09.2018 10:00;435;241;194;Leicht bewoelkt;19;19;0
04.09.2018 11:00;448;232;216;Leicht bewoelkt;20;20;0
04.09.2018 12:00;534;255;279;Leicht bewoelkt;22;22;0
04.09.2018 13:00;532;234;298;Leicht bewoelkt;22;22;0
04.09.2018 14:00;568;290;278;Leicht bewoelkt;22;24;0
04.09.2018 15:00;664;344;320;Leicht bewoelkt;23;25;0
04.09.2018 16:00;804;397;407;Leicht bewoelkt;22;22;0
04.09.2018 17:00;809;378;431;Leicht bewoelkt;21;21;0
04.09.2018 18:00;691;271;420;Leicht bewoelkt;20;20;0
04.09.2018 19:00;552;249;303;Leicht bewoelkt;18;19;0
04.09.2018 20:00;369;162;207;Leicht bewoelkt;17;17;0
04.09.2018 21:00;245;104;141;Leicht bewoelkt;16;16;0
04.09.2018 22:00;216;93;123;Leicht bewoelkt;15;16;0
04.09.2018 23:00;125;43;82;Leicht bewoelkt;15;15;0
05.09.2018 00:00;66;18;48;Leicht bewoelkt;14;14;0
05.09.2018 01:00;41;13;28;Leicht bewoelkt;14;14;0
05.09.2018 02:00;42;17;25;Leicht bewoelkt;14;14;0
05.09.2018 03:00;11;4;7;Leicht bewoelkt;14;14;0
05.09.2018 04:00;10;2;8;Leicht bewoelkt;14;14;0
05.09.2018 05:00;28;15;13;Leicht bewoelkt;14;14;0
05.09.2018 06:00;144;89;55;Leicht bewoelkt;14;14;0
05.09.2018 07:00;377;205;172;Leicht bewoelkt;16;16;0
05.09.2018 08:00;544;285;259;Leicht bewoelkt;18;18;0
05.09.2018 09:00;464;283;181;Leicht bewoelkt;19;19;0
05.09.2018 10:00;458;255;203;Leicht bewoelkt;21;21;0
05.09.2018 11:00;495;251;244;Leicht bewoelkt;22;24;0
05.09.2018 12:00;522;265;257;Leicht bewoelkt;24;25;0
05.09.2018 13:00;513;231;282;Leicht bewoelkt;24;26;0
05.09.2018 14:00;581;274;307;Leicht bewoelkt;24;26;0
05.09.2018 15:00;613;331;282;Leicht bewoelkt;25;26;0
05.09.2018 16:00;766;366;400;Leicht bewoelkt;24;25;0
05.09.2018 17:00;869;398;471;Leicht bewoelkt;23;23;0
05.09.2018 18:00;760;344;416;Leicht bewoelkt;22;22;0
05.09.2018 19:00;609;287;322;Leicht bewoelkt;21;21;0
05.09.2018 20:00;454;201;253;Sonnig;20;20;0
05.09.2018 21:00;266;110;156;Sonnig;19;19;0
05.09.2018 22:00;252;99;153;Sonnig;18;18;0
05.09.2018 23:00;135;53;82;Sonnig;17;17;0
06.09.2018 00:00;76;29;47;Sonnig;16;16;0
06.09.2018 01:00;39;16;23;Sonnig;16;16;0
06.09.2018 02:00;11;4;7;Leicht bewoelkt;15;15;0
06.09.2018 03:00;8;4;4;Leicht bewoelkt;15;15;0
06.09.2018 04:00;8;4;4;Leicht bewoelkt;15;15;0
06.09.2018 05:00;34;17;17;Leicht bewoelkt;15;15;0
06.09.2018 06:00;139;79;60;Leicht bewoelkt;15;15;0
06.09.2018 07:00;364;192;172;Leicht bewoelkt;17;17;0
06.09.2018 08:00;599;322;277;Leicht bewoelkt;19;19;0
06.09.2018 09:00;460;253;207;Leicht bewoelkt;20;20;0
06.09.2018 10:00;477;238;239;Leicht bewoelkt;21;21;0
06.09.2018 11:00;505;243;262;Leicht bewoelkt;23;24;0
06.09.2018 12:00;536;269;267;Leicht bewoelkt;24;25;0
06.09.2018 13:00;535;229;306;Leicht bewoelkt;24;26;0
06.09.2018 14:00;594;270;324;Leicht bewoelkt;24;26;0
06.09.2018 15:00;618;287;331;Leicht bewoelkt;25;26;0
06.09.2018 16:00;706;378;328;Leicht bewoelkt;24;25;0
06.09.2018 17:00;766;340;426;Leicht bewoelkt;23;25;0
06.09.2018 18:00;689;294;395;Leicht bewoelkt;22;22;0
06.09.2018 19:00;463;199;264;Leicht bewoelkt;20;20;0
06.09.2018 20:00;341;143;198;Leicht bewoelkt;19;19;0
06.09.2018 21:00;221;83;138;Leicht bewoelkt;17;17;0
06.09.2018 22:00;190;74;116;Leicht bewoelkt;17;17;0
06.09.2018 23:00;135;56;79;Leichter Regenschauer;16;16;0
07.09.2018 00:00;82;29;53;Leichter Regenschauer;15;15;0
07.09.2018 01:00;20;5;15;Leichter Regenschauer;15;15;0
07.09.2018 02:00;20;5;15;Leicht bewoelkt;15;15;0
07.09.2018 03:00;4;4;0;Leicht bewoelkt;15;15;0
07.09.2018 04:00;10;4;6;Leicht bewoelkt;15;15;0
07.09.2018 05:00;32;20;12;Leichter Regenschauer;15;15;0
07.09.2018 06:00;119;71;48;Leichter Regenschauer;15;15;0
07.09.2018 07:00;311;146;165;Leichter Regenschauer;15;15;0
07.09.2018 08:00;532;303;229;Leichter Regenschauer;16;16;0
07.09.2018 09:00;501;274;227;Leichter Regenschauer;16;16;0
07.09.2018 10:00;428;237;191;Leichter Regenschauer;17;17;0
07.09.2018 11:00;511;285;226;Leichter Regenschauer;18;18;0
07.09.2018 12:00;570;241;329;Leichter Regenschauer;18;18;0
07.09.2018 13:00;559;235;324;Leichter Regenschauer;19;19;0
07.09.2018 14:00;560;277;283;Leicht bewoelkt;19;19;0
07.09.2018 15:00;590;302;288;Leicht bewoelkt;19;19;0
07.09.2018 16:00;585;279;306;Leicht bewoelkt;18;18;0
07.09.2018 17:00;645;312;333;Stellenweiser Regenfall;17;17;0
07.09.2018 18:00;595;322;273;Stellenweiser Regenfall;17;17;0
07.09.2018 19:00;533;276;257;Stellenweiser Regenfall;16;16;0
07.09.2018 20:00;508;261;247;Leicht bewoelkt;15;15;0
07.09.2018 21:00;271;110;161;Leicht bewoelkt;14;15;0
07.09.2018 22:00;272;81;191;Leicht bewoelkt;14;14;0
07.09.2018 23:00;218;53;165;Stellenweiser Regenfall;13;14;0
08.09.2018 00:00;193;50;143;Stellenweiser Regenfall;13;13;0
08.09.2018 01:00;112;21;91;Stellenweiser Regenfall;13;13;0
08.09.2018 02:00;71;26;45;Leichter Regenschauer;13;13;0
08.09.2018 03:00;33;10;23;Leichter Regenschauer;13;13;0
08.09.2018 04:00;15;3;12;Leichter Regenschauer;13;13;0
08.09.2018 05:00;26;15;11;Leicht bewoelkt;13;13;0
08.09.2018 06:00;43;25;18;Leicht bewoelkt;14;14;0
08.09.2018 07:00;67;36;31;Leicht bewoelkt;15;15;0
08.09.2018 08:00;180;97;83;Leicht bewoelkt;16;16;0
08.09.2018 09:00;263;152;111;Leicht bewoelkt;18;18;0
08.09.2018 10:00;419;237;182;Leicht bewoelkt;19;19;0
08.09.2018 11:00;496;258;238;Leicht bewoelkt;21;21;0
08.09.2018 12:00;584;317;267;Leicht bewoelkt;23;24;0
08.09.2018 13:00;555;256;299;Leicht bewoelkt;23;24;0
08.09.2018 14:00;520;249;271;Leicht bewoelkt;23;25;0
08.09.2018 15:00;577;249;328;Leicht bewoelkt;24;25;0
08.09.2018 16:00;588;255;333;Leicht bewoelkt;23;25;0
08.09.2018 17:00;657;266;391;Leicht bewoelkt;22;25;0
08.09.2018 18:00;511;208;303;Leicht bewoelkt;21;21;0
08.09.2018 19:00;529;207;322;Leicht bewoelkt;20;20;0
08.09.2018 20:00;368;171;197;Leicht bewoelkt;20;20;0
08.09.2018 21:00;288;169;119;Leicht bewoelkt;19;19;0
08.09.2018 22:00;179;74;105;Leicht bewoelkt;18;18;0
08.09.2018 23:00;158;63;95;Leicht bewoelkt;17;17;0
09.09.2018 00:00;113;51;62;Leicht bewoelkt;16;16;0
09.09.2018 01:00;108;36;72;Leicht bewoelkt;15;15;0
09.09.2018 02:00;51;22;29;Leicht bewoelkt;14;14;0
09.09.2018 03:00;22;7;15;Leicht bewoelkt;13;13;0
09.09.2018 04:00;16;6;10;Leicht bewoelkt;13;13;0
09.09.2018 05:00;27;19;8;Leicht bewoelkt;14;14;0
09.09.2018 06:00;36;18;18;Leicht bewoelkt;14;14;0
09.09.2018 07:00;40;18;22;Leicht bewoelkt;16;16;0
09.09.2018 08:00;104;54;50;Leicht bewoelkt;18;18;0
09.09.2018 09:00;241;126;115;Leicht bewoelkt;19;19;0
09.09.2018 10:00;306;146;160;Leicht bewoelkt;21;21;0
09.09.2018 11:00;364;173;191;Leicht bewoelkt;22;24;0
09.09.2018 12:00;420;201;219;Leicht bewoelkt;24;25;0
09.09.2018 13:00;458;196;262;Leicht bewoelkt;24;25;0
09.09.2018 14:00;496;249;247;Leicht bewoelkt;24;26;0
09.09.2018 15:00;499;250;249;Leicht bewoelkt;25;26;0
09.09.2018 16:00;478;211;267;Leicht bewoelkt;24;26;0
09.09.2018 17:00;533;261;272;Leicht bewoelkt;24;26;0
09.09.2018 18:00;510;237;273;Leicht bewoelkt;23;25;0
09.09.2018 19:00;362;172;190;Leicht bewoelkt;22;25;0
09.09.2018 20:00;306;138;168;Sonnig;21;21;0
09.09.2018 21:00;156;75;81;Sonnig;20;20;0
09.09.2018 22:00;116;48;68;Sonnig;18;18;0
09.09.2018 23:00;77;36;41;Leicht bewoelkt;17;17;0
10.09.2018 00:00;32;13;19;Leicht bewoelkt;15;15;0
10.09.2018 01:00;11;7;4;Leicht bewoelkt;15;15;0
10.09.2018 02:00;9;7;2;Bedeckt;14;14;0
10.09.2018 03:00;4;2;2;Bedeckt;14;14;0
10.09.2018 04:00;6;3;3;Bedeckt;14;14;0
10.09.2018 05:00;34;16;18;Leicht bewoelkt;14;14;0
10.09.2018 06:00;161;92;69;Leicht bewoelkt;14;14;0
10.09.2018 07:00;512;267;245;Leicht bewoelkt;16;16;0
10.09.2018 08:00;817;420;397;Leicht bewoelkt;18;18;0
10.09.2018 09:00;857;602;255;Leicht bewoelkt;20;20;0
10.09.2018 10:00;467;255;212;Leicht bewoelkt;21;21;0
10.09.2018 11:00;579;229;350;Leicht bewoelkt;22;24;0
10.09.2018 12:00;706;287;419;Leicht bewoelkt;24;25;0
10.09.2018 13:00;899;431;468;Leicht bewoelkt;24;25;0
10.09.2018 14:00;646;330;316;Bewoelkt;25;26;0
10.09.2018 15:00;778;371;407;Bewoelkt;25;26;0
10.09.2018 16:00;839;387;452;Bewoelkt;24;26;0
10.09.2018 17:00;921;391;530;Leicht bewoelkt;24;26;0
10.09.2018 18:00;864;399;465;Leicht bewoelkt;23;25;0
10.09.2018 19:00;632;265;367;Leicht bewoelkt;22;25;0
10.09.2018 20:00;405;161;244;Leicht bewoelkt;21;21;0
10.09.2018 21:00;249;118;131;Leicht bewoelkt;20;20;0
10.09.2018 22:00;187;68;119;Leicht bewoelkt;19;19;0
10.09.2018 23:00;97;41;56;Leicht bewoelkt;17;18;0
11.09.2018 00:00;47;16;31;Leicht bewoelkt;16;16;0
11.09.2018 01:00;26;7;19;Leicht bewoelkt;16;16;0
11.09.2018 02:00;10;2;8;Leicht bewoelkt;15;16;0
11.09.2018 03:00;2;1;1;Leicht bewoelkt;15;15;0
11.09.2018 04:00;14;8;6;Leicht bewoelkt;15;15;0
11.09.2018 05:00;32;22;10;Leicht bewoelkt;15;15;0
11.09.2018 06:00;169;104;65;Leicht bewoelkt;15;15;0
11.09.2018 07:00;1096;701;395;Leicht bewoelkt;17;17;0
11.09.2018 08:00;751;413;338;Leicht bewoelkt;19;19;0
11.09.2018 09:00;555;306;249;Leicht bewoelkt;20;20;0
11.09.2018 10:00;469;234;235;Leicht bewoelkt;22;23;0
11.09.2018 11:00;516;262;254;Leicht bewoelkt;24;25;0
11.09.2018 12:00;701;303;398;Leicht bewoelkt;26;27;0
11.09.2018 13:00;1023;381;642;Leicht bewoelkt;26;27;0
11.09.2018 14:00;697;305;392;Leicht bewoelkt;27;28;0
11.09.2018 15:00;934;445;489;Leicht bewoelkt;28;29;0
11.09.2018 16:00;929;421;508;Leicht bewoelkt;27;29;0
11.09.2018 17:00;1008;486;522;Sonnig;27;28;0
11.09.2018 18:00;901;386;515;Sonnig;26;28;0
11.09.2018 19:00;722;327;395;Sonnig;25;27;0
11.09.2018 20:00;463;196;267;Sonnig;24;27;0
11.09.2018 21:00;316;142;174;Sonnig;22;26;0
11.09.2018 22:00;192;82;110;Sonnig;21;21;0
11.09.2018 23:00;120;42;78;Sonnig;20;20;0
12.09.2018 00:00;66;26;40;Sonnig;19;19;0
12.09.2018 01:00;27;7;20;Sonnig;18;18;0
12.09.2018 02:00;12;2;10;Sonnig;18;18;0
12.09.2018 03:00;5;2;3;Sonnig;17;17;0
12.09.2018 04:00;4;2;2;Sonnig;17;17;0
12.09.2018 05:00;46;23;23;Sonnig;17;17;0
12.09.2018 06:00;153;94;59;Sonnig;17;17;0
12.09.2018 07:00;1179;702;477;Sonnig;19;19;0
12.09.2018 08:00;677;360;317;Sonnig;20;20;0
12.09.2018 09:00;523;277;246;Sonnig;22;22;0
12.09.2018 10:00;446;261;185;Sonnig;23;24;0
12.09.2018 11:00;568;310;258;Leicht bewoelkt;24;25;0
12.09.2018 12:00;731;265;466;Leicht bewoelkt;25;27;0
12.09.2018 13:00;1063;428;635;Leicht bewoelkt;26;27;0
12.09.2018 14:00;677;316;361;Leicht bewoelkt;26;27;0
12.09.2018 15:00;917;423;494;Leicht bewoelkt;27;28;0
12.09.2018 16:00;866;425;441;Leicht bewoelkt;26;28;0
12.09.2018 17:00;1017;472;545;Leicht bewoelkt;26;28;0
12.09.2018 18:00;906;417;489;Leicht bewoelkt;25;28;0
12.09.2018 19:00;678;312;366;Leicht bewoelkt;24;27;0
12.09.2018 20:00;497;202;295;Stellenweise Gewitter und Niederschlaege;23;26;0
12.09.2018 21:00;315;132;183;Stellenweise Gewitter und Niederschlaege;22;25;1
12.09.2018 22:00;252;91;161;Stellenweise Gewitter und Niederschlaege;21;21;1
12.09.2018 23:00;145;50;95;Maessiger bis starker Regenschauer;19;19;1
13.09.2018 00:00;77;20;57;Maessiger bis starker Regenschauer;18;18;1
13.09.2018 01:00;55;21;34;Maessiger bis starker Regenschauer;17;17;1
13.09.2018 02:00;18;9;9;Maessiger bis starker Regenschauer;16;16;1
13.09.2018 03:00;10;5;5;Maessiger bis starker Regenschauer;16;16;0
13.09.2018 04:00;5;2;3;Maessiger bis starker Regenschauer;16;16;0
13.09.2018 05:00;31;15;16;Teilweise maessiger Regenfall;16;16;0
13.09.2018 06:00;154;93;61;Teilweise maessiger Regenfall;16;16;0
13.09.2018 07:00;1029;632;397;Teilweise maessiger Regenfall;17;17;0
13.09.2018 08:00;657;339;318;Teilweise maessiger Regenfall;19;19;0
13.09.2018 09:00;506;301;205;Teilweise maessiger Regenfall;20;20;0
13.09.2018 10:00;395;206;189;Teilweise maessiger Regenfall;22;22;0
13.09.2018 11:00;481;260;221;Leicht bewoelkt;23;25;0
13.09.2018 12:00;628;257;371;Leicht bewoelkt;24;26;0
13.09.2018 13:00;921;355;566;Leicht bewoelkt;25;26;0
13.09.2018 14:00;644;322;322;Leicht bewoelkt;25;26;0
13.09.2018 15:00;824;405;419;Leicht bewoelkt;25;26;0
13.09.2018 16:00;836;412;424;Leicht bewoelkt;24;26;0
13.09.2018 17:00;911;364;547;Stellenweiser Regenfall;23;25;0
13.09.2018 18:00;621;283;338;Stellenweiser Regenfall;22;22;0
13.09.2018 19:00;395;172;223;Stellenweiser Regenfall;20;20;0
13.09.2018 20:00;306;150;156;Leichter Regenschauer;19;19;0
13.09.2018 21:00;149;57;92;Leichter Regenschauer;18;18;1
13.09.2018 22:00;144;60;84;Leichter Regenschauer;18;18;1
13.09.2018 23:00;85;28;57;Leichter Regenschauer;17;17;1
14.09.2018 00:00;51;19;32;Leichter Regenschauer;17;17;1
14.09.2018 01:00;25;7;18;Leichter Regenschauer;16;16;0
14.09.2018 02:00;6;2;4;Leichter Regenschauer;16;16;0
14.09.2018 03:00;5;2;3;Leichter Regenschauer;16;16;0
14.09.2018 04:00;11;7;4;Leichter Regenschauer;16;16;0
14.09.2018 05:00;39;23;16;Leichter Regenschauer;16;16;0
14.09.2018 06:00;133;75;58;Leichter Regenschauer;16;16;0
14.09.2018 07:00;815;473;342;Leichter Regenschauer;16;16;0
14.09.2018 08:00;581;316;265;Leichter Regenschauer;17;17;0
14.09.2018 09:00;560;387;173;Leichter Regenschauer;17;17;0
14.09.2018 10:00;470;244;226;Leichter Regenschauer;18;18;0
14.09.2018 11:00;496;248;248;Leichter Regenschauer;19;19;0
14.09.2018 12:00;614;301;313;Leichter Regenschauer;20;20;0
14.09.2018 13:00;946;369;577;Leichter Regenschauer;21;21;0
14.09.2018 14:00;700;339;361;Stellenweiser Regenfall;21;21;0
14.09.2018 15:00;704;356;348;Stellenweiser Regenfall;22;25;0
14.09.2018 16:00;665;314;351;Stellenweiser Regenfall;21;21;0
14.09.2018 17:00;720;287;433;Stellenweiser Regenfall;20;20;0
14.09.2018 18:00;692;302;390;Stellenweiser Regenfall;20;20;0
14.09.2018 19:00;495;232;263;Stellenweiser Regenfall;18;18;0
14.09.2018 20:00;415;178;237;Stellenweiser Regenfall;17;17;0
14.09.2018 21:00;239;123;116;Stellenweiser Regenfall;16;16;0
14.09.2018 22:00;205;91;114;Stellenweiser Regenfall;15;15;0
14.09.2018 23:00;171;73;98;Stellenweiser Regenfall;15;15;0
15.09.2018 00:00;308;137;171;Stellenweiser Regenfall;15;15;0
15.09.2018 01:00;92;26;66;Stellenweiser Regenfall;15;15;0
15.09.2018 02:00;57;18;39;Stellenweiser Regenfall;14;15;0
15.09.2018 03:00;32;13;19;Stellenweiser Regenfall;14;15;0
15.09.2018 04:00;24;12;12;Stellenweiser Regenfall;14;15;0
15.09.2018 05:00;24;16;8;Leichter Regenschauer;14;15;0
15.09.2018 06:00;50;24;26;Leichter Regenschauer;14;15;0
15.09.2018 07:00;73;46;27;Leichter Regenschauer;15;15;0
15.09.2018 08:00;102;59;43;Bedeckt;15;15;0
15.09.2018 09:00;381;231;150;Bedeckt;16;16;0
15.09.2018 10:00;526;263;263;Bedeckt;17;17;0
15.09.2018 11:00;541;278;263;Stellenweiser Regenfall;18;18;0
15.09.2018 12:00;582;315;267;Stellenweiser Regenfall;19;19;0
15.09.2018 13:00;601;312;289;Stellenweiser Regenfall;20;20;0
15.09.2018 14:00;663;260;403;Stellenweiser Regenfall;20;20;0
15.09.2018 15:00;662;339;323;Stellenweiser Regenfall;21;21;0
15.09.2018 16:00;664;350;314;Stellenweiser Regenfall;19;19;0
15.09.2018 17:00;625;288;337;Leicht bewoelkt;18;18;0
15.09.2018 18:00;527;253;274;Leicht bewoelkt;17;17;0
15.09.2018 19:00;500;234;266;Leicht bewoelkt;16;16;0
15.09.2018 20:00;336;149;187;Leicht bewoelkt;15;15;0
15.09.2018 21:00;280;105;175;Leicht bewoelkt;14;14;0
15.09.2018 22:00;226;79;147;Leicht bewoelkt;13;13;0
15.09.2018 23:00;191;68;123;Leicht bewoelkt;13;13;0
16.09.2018 00:00;117;41;76;Leicht bewoelkt;12;12;0
16.09.2018 01:00;130;39;91;Leicht bewoelkt;12;12;0
16.09.2018 02:00;66;15;51;Leicht bewoelkt;12;12;0
16.09.2018 03:00;44;12;32;Leicht bewoelkt;12;12;0
16.09.2018 04:00;41;14;27;Leicht bewoelkt;12;12;0
16.09.2018 05:00;19;13;6;Leicht bewoelkt;12;12;0
16.09.2018 06:00;35;17;18;Leicht bewoelkt;12;13;0
16.09.2018 07:00;40;22;18;Leicht bewoelkt;14;14;0
16.09.2018 08:00;92;42;50;Leicht bewoelkt;16;16;0
16.09.2018 09:00;224;112;112;Leicht bewoelkt;18;18;0
16.09.2018 10:00;248;122;126;Leicht bewoelkt;19;19;0
16.09.2018 11:00;351;162;189;Leicht bewoelkt;21;21;0
16.09.2018 12:00;381;158;223;Leicht bewoelkt;23;24;0
16.09.2018 13:00;440;219;221;Leicht bewoelkt;24;25;0
16.09.2018 14:00;489;251;238;Leicht bewoelkt;24;25;0
16.09.2018 15:00;572;322;250;Leicht bewoelkt;25;26;0
16.09.2018 16:00;475;213;262;Leicht bewoelkt;24;26;0
16.09.2018 17:00;464;218;246;Leicht bewoelkt;24;26;0
16.09.2018 18:00;428;218;210;Leicht bewoelkt;23;26;0
16.09.2018 19:00;306;161;145;Leicht bewoelkt;22;22;0
16.09.2018 20:00;205;76;129;Leicht bewoelkt;21;21;0
16.09.2018 21:00;107;43;64;Leicht bewoelkt;20;20;0
16.09.2018 22:00;112;45;67;Leicht bewoelkt;19;19;0
16.09.2018 23:00;64;23;41;Leicht bewoelkt;18;18;0
17.09.2018 00:00;46;20;26;Leicht bewoelkt;17;17;0
17.09.2018 01:00;10;8;2;Leicht bewoelkt;16;17;0
17.09.2018 02:00;20;4;16;Leicht bewoelkt;16;16;0
17.09.2018 03:00;6;2;4;Leicht bewoelkt;15;16;0
17.09.2018 04:00;6;4;2;Leicht bewoelkt;15;16;0
17.09.2018 05:00;44;22;22;Leicht bewoelkt;15;16;0
17.09.2018 06:00;162;98;64;Leicht bewoelkt;15;15;0
17.09.2018 07:00;1028;655;373;Leicht bewoelkt;17;17;0
17.09.2018 08:00;716;382;334;Leicht bewoelkt;19;19;0
17.09.2018 09:00;528;335;193;Leicht bewoelkt;20;20;0
17.09.2018 10:00;384;181;203;Leicht bewoelkt;22;22;0
17.09.2018 11:00;469;203;266;Leicht bewoelkt;23;25;0
17.09.2018 12:00;536;273;263;Leicht bewoelkt;25;26;0
17.09.2018 13:00;853;341;512;Leicht bewoelkt;25;26;0
17.09.2018 14:00;638;304;334;Leicht bewoelkt;25;27;0
17.09.2018 15:00;1018;490;528;Leicht bewoelkt;26;27;0
17.09.2018 16:00;886;433;453;Leicht bewoelkt;25;26;0
17.09.2018 17:00;1046;428;618;Leicht bewoelkt;24;26;0
17.09.2018 18:00;874;390;484;Leicht bewoelkt;24;25;0
17.09.2018 19:00;632;267;365;Leicht bewoelkt;23;25;0
17.09.2018 20:00;431;170;261;Leicht bewoelkt;22;25;0
17.09.2018 21:00;266;125;141;Leicht bewoelkt;21;21;0
17.09.2018 22:00;171;79;92;Leicht bewoelkt;20;20;0
17.09.2018 23:00;95;34;61;Leicht bewoelkt;19;19;0
18.09.2018 00:00;58;14;44;Leicht bewoelkt;17;17;0
18.09.2018 01:00;27;11;16;Leicht bewoelkt;17;17;0
18.09.2018 02:00;14;6;8;Leicht bewoelkt;16;16;0
18.09.2018 03:00;5;4;1;Leicht bewoelkt;15;16;0
18.09.2018 04:00;5;4;1;Leicht bewoelkt;15;16;0
18.09.2018 05:00;36;20;16;Leicht bewoelkt;15;16;0
18.09.2018 06:00;173;113;60;Leicht bewoelkt;15;15;0
18.09.2018 07:00;1031;656;375;Leicht bewoelkt;17;17;0
18.09.2018 08:00;806;427;379;Leicht bewoelkt;18;18;0
18.09.2018 09:00;564;327;237;Leicht bewoelkt;20;20;0
18.09.2018 10:00;451;246;205;Leicht bewoelkt;21;21;0
18.09.2018 11:00;591;301;290;Leicht bewoelkt;23;24;0
18.09.2018 12:00;634;279;355;Leicht bewoelkt;24;25;0
18.09.2018 13:00;896;350;546;Leicht bewoelkt;24;26;0
18.09.2018 14:00;687;306;381;Leicht bewoelkt;24;26;0
18.09.2018 15:00;1006;457;549;Leicht bewoelkt;25;26;0
18.09.2018 16:00;852;414;438;Leicht bewoelkt;24;26;0
18.09.2018 17:00;1052;468;584;Leicht bewoelkt;24;25;0
18.09.2018 18:00;814;345;469;Leicht bewoelkt;23;25;0
18.09.2018 19:00;695;287;408;Leicht bewoelkt;22;25;0
18.09.2018 20:00;377;145;232;Leicht bewoelkt;21;21;0
18.09.2018 21:00;254;119;135;Leicht bewoelkt;21;21;0
18.09.2018 22:00;235;102;133;Leicht bewoelkt;19;19;0
18.09.2018 23:00;106;45;61;Leicht bewoelkt;18;18;0
19.09.2018 00:00;39;15;24;Leicht bewoelkt;17;17;0
19.09.2018 01:00;28;14;14;Leicht bewoelkt;16;16;0
19.09.2018 02:00;9;5;4;Leicht bewoelkt;15;16;0
19.09.2018 03:00;2;0;2;Leicht bewoelkt;15;15;0
19.09.2018 04:00;7;6;1;Leicht bewoelkt;15;15;0
19.09.2018 05:00;39;19;20;Leicht bewoelkt;15;15;0
19.09.2018 06:00;163;95;68;Leicht bewoelkt;15;15;0
19.09.2018 07:00;1069;645;424;Leicht bewoelkt;16;17;0
19.09.2018 08:00;739;423;316;Leicht bewoelkt;18;18;0
19.09.2018 09:00;610;374;236;Leicht bewoelkt;20;20;0
19.09.2018 10:00;395;191;204;Leicht bewoelkt;21;21;0
19.09.2018 11:00;491;240;251;Leicht bewoelkt;23;24;0
19.09.2018 12:00;612;272;340;Leicht bewoelkt;25;26;0
19.09.2018 13:00;1036;414;622;Leicht bewoelkt;25;27;0
19.09.2018 14:00;695;341;354;Leicht bewoelkt;26;27;0
19.09.2018 15:00;923;416;507;Leicht bewoelkt;27;28;0
19.09.2018 16:00;870;422;448;Leicht bewoelkt;27;28;0
19.09.2018 17:00;1054;466;588;Leicht bewoelkt;26;28;0
19.09.2018 18:00;896;385;511;Leicht bewoelkt;26;29;0
19.09.2018 19:00;699;352;347;Leicht bewoelkt;25;28;0
19.09.2018 20:00;496;198;298;Leicht bewoelkt;24;28;0
19.09.2018 21:00;299;114;185;Leicht bewoelkt;24;27;0
19.09.2018 22:00;237;105;132;Leicht bewoelkt;22;22;0
19.09.2018 23:00;159;53;106;Leicht bewoelkt;20;20;0
20.09.2018 00:00;81;23;58;Leicht bewoelkt;18;18;0
20.09.2018 01:00;53;14;39;Leicht bewoelkt;17;17;0
20.09.2018 02:00;13;6;7;Leicht bewoelkt;16;16;0
20.09.2018 03:00;6;3;3;Leicht bewoelkt;15;15;0
20.09.2018 04:00;9;5;4;Leicht bewoelkt;15;15;0
20.09.2018 05:00;37;24;13;Leicht bewoelkt;15;15;0
20.09.2018 06:00;155;89;66;Leicht bewoelkt;15;15;0
20.09.2018 07:00;1062;673;389;Leicht bewoelkt;17;17;0
20.09.2018 08:00;673;330;343;Leicht bewoelkt;18;18;0
20.09.2018 09:00;546;305;241;Leicht bewoelkt;20;20;0
20.09.2018 10:00;373;202;171;Leicht bewoelkt;22;22;0
20.09.2018 11:00;582;282;300;Leicht bewoelkt;23;25;0
20.09.2018 12:00;603;274;329;Leicht bewoelkt;25;26;0
20.09.2018 13:00;852;330;522;Leicht bewoelkt;26;27;0
20.09.2018 14:00;646;313;333;Leicht bewoelkt;26;27;0
20.09.2018 15:00;958;461;497;Leicht bewoelkt;27;28;0
20.09.2018 16:00;871;408;463;Leicht bewoelkt;26;28;0
20.09.2018 17:00;1072;465;607;Leicht bewoelkt;26;28;0
20.09.2018 18:00;834;374;460;Leicht bewoelkt;25;28;0
20.09.2018 19:00;665;282;383;Leicht bewoelkt;25;27;0
20.09.2018 20:00;407;185;222;Leicht bewoelkt;24;26;0
20.09.2018 21:00;307;119;188;Leicht bewoelkt;23;26;0
20.09.2018 22:00;261;104;157;Leicht bewoelkt;21;21;0
20.09.2018 23:00;122;45;77;Sonnig;20;20;0
21.09.2018 00:00;373;188;185;Sonnig;18;18;0
21.09.2018 01:00;51;19;32;Sonnig;17;17;0
21.09.2018 02:00;10;6;4;Leicht bewoelkt;17;17;0
21.09.2018 03:00;4;3;1;Leicht bewoelkt;16;16;0
21.09.2018 04:00;6;6;0;Leicht bewoelkt;16;16;0
21.09.2018 05:00;30;15;15;Leicht bewoelkt;16;16;0
21.09.2018 06:00;160;102;58;Leicht bewoelkt;16;16;0
21.09.2018 07:00;996;637;359;Leicht bewoelkt;18;18;0
21.09.2018 08:00;634;339;295;Leicht bewoelkt;19;19;0
21.09.2018 09:00;543;346;197;Leicht bewoelkt;21;21;0
21.09.2018 10:00;471;258;213;Leicht bewoelkt;22;23;0
21.09.2018 11:00;609;281;328;Leicht bewoelkt;24;25;0
21.09.2018 12:00;756;316;440;Leicht bewoelkt;25;26;0
21.09.2018 13:00;1031;371;660;Leicht bewoelkt;24;26;0
21.09.2018 14:00;669;314;355;Leicht bewoelkt;23;25;0
21.09.2018 15:00;650;310;340;Leicht bewoelkt;23;25;0
21.09.2018 16:00;638;301;337;Leicht bewoelkt;22;22;0
21.09.2018 17:00;602;284;318;Bewoelkt;20;20;0
21.09.2018 18:00;482;201;281;Bewoelkt;19;19;0
21.09.2018 19:00;481;221;260;Bewoelkt;18;18;0
21.09.2018 20:00;210;97;113;Bedeckt;17;17;1
21.09.2018 21:00;158;77;81;Bedeckt;16;16;1
21.09.2018 22:00;136;37;99;Bedeckt;15;15;1
21.09.2018 23:00;120;38;82;Maessiger Regenfall;14;14;2
22.09.2018 00:00;76;32;44;Maessiger Regenfall;14;14;2
22.09.2018 01:00;53;15;38;Maessiger Regenfall;13;13;2
22.09.2018 02:00;46;14;32;Teilweise maessiger Regenfall;12;12;1
22.09.2018 03:00;31;9;22;Teilweise maessiger Regenfall;11;11;1
22.09.2018 04:00;8;4;4;Teilweise maessiger Regenfall;11;11;0
22.09.2018 05:00;25;15;10;Stellenweiser Regenfall;11;11;0
22.09.2018 06:00;62;25;37;Stellenweiser Regenfall;11;11;0
22.09.2018 07:00;81;43;38;Stellenweiser Regenfall;12;12;0
22.09.2018 08:00;165;101;64;Stellenweiser Regenfall;12;13;0
22.09.2018 09:00;324;186;138;Stellenweiser Regenfall;13;13;0
22.09.2018 10:00;381;191;190;Stellenweiser Regenfall;14;15;0
22.09.2018 11:00;425;236;189;Leicht bewoelkt;16;16;0
22.09.2018 12:00;461;229;232;Leicht bewoelkt;17;17;0
22.09.2018 13:00;482;241;241;Leicht bewoelkt;17;17;0
22.09.2018 14:00;557;289;268;Leicht bewoelkt;18;18;0
22.09.2018 15:00;558;255;303;Leicht bewoelkt;18;18;0
22.09.2018 16:00;555;276;279;Leicht bewoelkt;17;17;0
22.09.2018 17:00;509;231;278;Leicht bewoelkt;17;17;0
22.09.2018 18:00;497;204;293;Leicht bewoelkt;16;16;0
22.09.2018 19:00;406;165;241;Leicht bewoelkt;15;15;0
22.09.2018 20:00;278;118;160;Leicht bewoelkt;15;15;0
22.09.2018 21:00;215;106;109;Leicht bewoelkt;14;14;0
22.09.2018 22:00;136;65;71;Leicht bewoelkt;14;14;0
22.09.2018 23:00;146;43;103;Nieselregen;14;14;0
23.09.2018 00:00;136;50;86;Nieselregen;14;14;0
23.09.2018 01:00;77;29;48;Nieselregen;14;14;0
23.09.2018 02:00;51;20;31;Bewoelkt;14;14;0
23.09.2018 03:00;56;18;38;Bewoelkt;15;14;0
23.09.2018 04:00;25;6;19;Bewoelkt;15;15;0
23.09.2018 05:00;29;6;23;Leichter Regenfall;16;15;0
23.09.2018 06:00;31;16;15;Leichter Regenfall;16;16;0
23.09.2018 07:00;36;22;14;Leichter Regenfall;17;17;0
23.09.2018 08:00;80;35;45;Bedeckt;17;17;0
23.09.2018 09:00;186;99;87;Bedeckt;18;18;0
23.09.2018 10:00;205;93;112;Bedeckt;19;19;0
23.09.2018 11:00;234;108;126;Stellenweiser Regenfall;20;20;0
23.09.2018 12:00;324;147;177;Stellenweiser Regenfall;21;21;0
23.09.2018 13:00;282;130;152;Stellenweiser Regenfall;22;24;0
23.09.2018 14:00;331;152;179;Leicht bewoelkt;23;25;0
23.09.2018 15:00;419;192;227;Leicht bewoelkt;24;26;0
23.09.2018 16:00;374;193;181;Leicht bewoelkt;24;26;0
23.09.2018 17:00;353;187;166;Leicht bewoelkt;23;26;0
23.09.2018 18:00;344;167;177;Leicht bewoelkt;23;26;0
23.09.2018 19:00;282;135;147;Leicht bewoelkt;22;22;1
23.09.2018 20:00;178;78;100;Leicht bewoelkt;21;21;2
23.09.2018 21:00;69;26;43;Leicht bewoelkt;20;20;3
23.09.2018 22:00;88;28;60;Leicht bewoelkt;18;18;4
23.09.2018 23:00;49;19;30;Starker Regenfall;16;15;5
24.09.2018 00:00;23;6;17;Starker Regenfall;14;13;6
24.09.2018 01:00;8;2;6;Starker Regenfall;13;11;4
24.09.2018 02:00;6;3;3;Starker Regenfall;11;10;3
24.09.2018 03:00;3;3;0;Starker Regenfall;10;8;2
24.09.2018 04:00;4;4;0;Starker Regenfall;10;8;2
24.09.2018 05:00;34;16;18;Leichter Regenschauer;9;8;1
24.09.2018 06:00;138;82;56;Leichter Regenschauer;9;8;0
24.09.2018 07:00;885;523;362;Leichter Regenschauer;9;8;0
24.09.2018 08:00;670;379;291;Leichter Regenschauer;10;8;0
24.09.2018 09:00;432;268;164;Leichter Regenschauer;10;9;0
24.09.2018 10:00;367;205;162;Leichter Regenschauer;11;10;0
24.09.2018 11:00;397;189;208;Stellenweiser Regenfall;11;11;0
24.09.2018 12:00;552;244;308;Stellenweiser Regenfall;12;12;0
24.09.2018 13:00;740;267;473;Stellenweiser Regenfall;13;12;0
24.09.2018 14:00;567;286;281;Stellenweiser Regenfall;13;13;0
24.09.2018 15:00;808;393;415;Stellenweiser Regenfall;14;13;0
24.09.2018 16:00;801;386;415;Stellenweiser Regenfall;13;12;0
24.09.2018 17:00;882;374;508;Leicht bewoelkt;12;12;0
24.09.2018 18:00;721;296;425;Leicht bewoelkt;11;11;0
24.09.2018 19:00;529;247;282;Leicht bewoelkt;10;9;0
24.09.2018 20:00;352;148;204;Leicht bewoelkt;9;8;0
24.09.2018 21:00;200;83;117;Leicht bewoelkt;8;6;0
24.09.2018 22:00;139;57;82;Leicht bewoelkt;7;6;0
24.09.2018 23:00;89;33;56;Leicht bewoelkt;7;5;0
25.09.2018 00:00;41;11;30;Leicht bewoelkt;6;4;0
25.09.2018 01:00;43;9;34;Leicht bewoelkt;6;4;0
25.09.2018 02:00;11;3;8;Bewoelkt;6;4;0
25.09.2018 03:00;6;5;1;Bewoelkt;6;4;0
25.09.2018 04:00;5;3;2;Bewoelkt;6;4;0
25.09.2018 05:00;31;20;11;Sonnig;6;3;0
25.09.2018 06:00;147;97;50;Sonnig;6;3;0
25.09.2018 07:00;887;543;344;Sonnig;7;4;0
25.09.2018 08:00;706;370;336;Sonnig;8;6;0
25.09.2018 09:00;516;318;198;Sonnig;9;7;0
25.09.2018 10:00;360;189;171;Sonnig;11;8;0
25.09.2018 11:00;479;250;229;Sonnig;12;10;0
25.09.2018 12:00;551;240;311;Sonnig;13;11;0
25.09.2018 13:00;830;319;511;Sonnig;13;11;0
25.09.2018 14:00;561;244;317;Sonnig;14;12;0
25.09.2018 15:00;862;390;472;Sonnig;14;12;0
25.09.2018 16:00;812;415;397;Sonnig;13;11;0
25.09.2018 17:00;952;438;514;Sonnig;12;9;0
25.09.2018 18:00;729;293;436;Sonnig;11;8;0
25.09.2018 19:00;579;288;291;Sonnig;10;7;0
25.09.2018 20:00;332;153;179;Sonnig;9;6;0
25.09.2018 21:00;212;82;130;Sonnig;8;5;0
25.09.2018 22:00;209;60;149;Sonnig;7;5;0
25.09.2018 23:00;97;37;60;Sonnig;7;5;0
26.09.2018 00:00;46;7;39;Sonnig;6;4;0
26.09.2018 01:00;34;15;19;Sonnig;6;4;0
26.09.2018 02:00;7;1;6;Sonnig;6;4;0
26.09.2018 03:00;9;6;3;Sonnig;5;4;0
26.09.2018 04:00;5;5;0;Sonnig;5;4;0
26.09.2018 05:00;40;21;19;Leicht bewoelkt;5;4;0
26.09.2018 06:00;140;75;65;Leicht bewoelkt;5;4;0
26.09.2018 07:00;946;500;446;Leicht bewoelkt;7;6;0
26.09.2018 08:00;721;423;298;Leicht bewoelkt;9;8;0
26.09.2018 09:00;507;307;200;Leicht bewoelkt;10;10;0
26.09.2018 10:00;329;154;175;Leicht bewoelkt;12;12;0
26.09.2018 11:00;422;196;226;Leicht bewoelkt;15;15;0
26.09.2018 12:00;612;284;328;Leicht bewoelkt;17;17;0
26.09.2018 13:00;903;375;528;Leicht bewoelkt;18;18;0
26.09.2018 14:00;587;263;324;Leicht bewoelkt;19;19;0
26.09.2018 15:00;755;327;428;Leicht bewoelkt;20;20;0
26.09.2018 16:00;786;364;422;Leicht bewoelkt;19;19;0
26.09.2018 17:00;902;361;541;Leicht bewoelkt;19;19;0
26.09.2018 18:00;743;324;419;Leicht bewoelkt;18;18;0
26.09.2018 19:00;575;247;328;Leicht bewoelkt;17;17;0
26.09.2018 20:00;381;202;179;Leicht bewoelkt;16;16;0
26.09.2018 21:00;245;109;136;Leicht bewoelkt;15;15;0
26.09.2018 22:00;232;103;129;Leicht bewoelkt;14;14;0
26.09.2018 23:00;117;55;62;Leicht bewoelkt;13;13;0
27.09.2018 00:00;82;28;54;Leicht bewoelkt;12;12;0
27.09.2018 01:00;51;7;44;Leicht bewoelkt;12;12;0
27.09.2018 02:00;24;9;15;Leicht bewoelkt;11;11;0
27.09.2018 03:00;4;2;2;Leicht bewoelkt;11;11;0
27.09.2018 04:00;6;6;0;Leicht bewoelkt;11;11;0
27.09.2018 05:00;32;21;11;Leicht bewoelkt;10;10;0
27.09.2018 06:00;125;69;56;Leicht bewoelkt;10;10;0
27.09.2018 07:00;865;518;347;Leicht bewoelkt;12;12;0
27.09.2018 08:00;651;359;292;Leicht bewoelkt;14;14;0
27.09.2018 09:00;483;311;172;Leicht bewoelkt;16;16;0
27.09.2018 10:00;347;188;159;Leicht bewoelkt;18;18;0
27.09.2018 11:00;453;204;249;Leicht bewoelkt;20;20;0
27.09.2018 12:00;571;237;334;Leicht bewoelkt;22;22;0
27.09.2018 13:00;771;310;461;Leicht bewoelkt;22;23;0
27.09.2018 14:00;596;309;287;Sonnig;23;24;0
27.09.2018 15:00;820;416;404;Sonnig;24;25;0
27.09.2018 16:00;866;420;446;Sonnig;23;25;0
27.09.2018 17:00;927;354;573;Sonnig;22;24;0
27.09.2018 18:00;921;389;532;Sonnig;21;21;0
27.09.2018 19:00;588;263;325;Sonnig;20;20;0
27.09.2018 20:00;429;217;212;Sonnig;19;19;0
27.09.2018 21:00;287;122;165;Sonnig;17;17;0
27.09.2018 22:00;217;100;117;Sonnig;16;16;0
27.09.2018 23:00;159;83;76;Sonnig;15;15;0
28.09.2018 00:00;55;9;46;Sonnig;14;15;0
28.09.2018 01:00;30;11;19;Sonnig;14;14;0
28.09.2018 02:00;18;13;5;Sonnig;13;14;0
28.09.2018 03:00;8;5;3;Sonnig;13;13;0
28.09.2018 04:00;7;6;1;Sonnig;12;13;0
28.09.2018 05:00;36;20;16;Sonnig;12;12;0
28.09.2018 06:00;123;68;55;Sonnig;12;12;0
28.09.2018 07:00;837;502;335;Sonnig;13;13;0
28.09.2018 08:00;620;357;263;Leicht bewoelkt;15;15;0
28.09.2018 09:00;523;320;203;Leicht bewoelkt;16;16;0
28.09.2018 10:00;454;265;189;Leicht bewoelkt;18;18;0
28.09.2018 11:00;583;233;350;Leicht bewoelkt;19;19;0
28.09.2018 12:00;724;329;395;Leicht bewoelkt;21;21;0
28.09.2018 13:00;882;402;480;Leicht bewoelkt;21;21;0
28.09.2018 14:00;663;334;329;Leicht bewoelkt;21;21;0
28.09.2018 15:00;792;421;371;Leicht bewoelkt;21;21;0
28.09.2018 16:00;767;379;388;Leicht bewoelkt;20;20;0
28.09.2018 17:00;802;371;431;Leicht bewoelkt;19;19;0
28.09.2018 18:00;710;315;395;Leicht bewoelkt;18;18;0
28.09.2018 19:00;504;211;293;Leicht bewoelkt;17;17;0
28.09.2018 20:00;346;152;194;Stellenweiser Regenfall;16;15;0
28.09.2018 21:00;184;94;90;Stellenweiser Regenfall;15;14;0
28.09.2018 22:00;194;65;129;Stellenweiser Regenfall;14;12;0
28.09.2018 23:00;179;66;113;Stellenweiser Regenfall;13;11;0
29.09.2018 00:00;131;37;94;Stellenweiser Regenfall;12;9;0
29.09.2018 01:00;95;22;73;Stellenweiser Regenfall;11;9;0
29.09.2018 02:00;39;11;28;Stellenweiser Regenfall;10;8;0
29.09.2018 03:00;32;8;24;Stellenweiser Regenfall;10;7;0
29.09.2018 04:00;12;8;4;Stellenweiser Regenfall;9;6;0
29.09.2018 05:00;30;19;11;Leicht bewoelkt;9;6;0
29.09.2018 06:00;40;24;16;Leicht bewoelkt;9;6;0
29.09.2018 07:00;71;41;30;Leicht bewoelkt;10;7;0
29.09.2018 08:00;166;101;65;Leicht bewoelkt;11;8;0
29.09.2018 09:00;308;172;136;Leicht bewoelkt;12;9;0
29.09.2018 10:00;360;229;131;Leicht bewoelkt;13;11;0
29.09.2018 11:00;419;218;201;Leicht bewoelkt;14;13;0
29.09.2018 12:00;490;271;219;Leicht bewoelkt;15;14;0
29.09.2018 13:00;486;235;251;Leicht bewoelkt;15;15;0
29.09.2018 14:00;550;242;308;Leicht bewoelkt;16;16;0
29.09.2018 15:00;509;255;254;Leicht bewoelkt;16;16;0
29.09.2018 16:00;593;298;295;Leicht bewoelkt;16;16;0
29.09.2018 17:00;538;252;286;Sonnig;15;15;0
29.09.2018 18:00;455;185;270;Sonnig;15;15;0
29.09.2018 19:00;399;174;225;Sonnig;14;14;0
29.09.2018 20:00;295;124;171;Leicht bewoelkt;14;14;0
29.09.2018 21:00;209;101;108;Leicht bewoelkt;13;13;0
29.09.2018 22:00;181;68;113;Leicht bewoelkt;12;12;0
29.09.2018 23:00;156;69;87;Leicht bewoelkt;11;10;0
30.09.2018 00:00;140;50;90;Leicht bewoelkt;9;9;0
30.09.2018 01:00;97;30;67;Leicht bewoelkt;9;9;0
30.09.2018 02:00;65;14;51;Leicht bewoelkt;8;8;0
30.09.2018 03:00;50;21;29;Leicht bewoelkt;8;8;0
30.09.2018 04:00;19;10;9;Leicht bewoelkt;8;8;0
30.09.2018 05:00;20;11;9;Leicht bewoelkt;8;8;0
30.09.2018 06:00;28;14;14;Leicht bewoelkt;8;8;0
30.09.2018 07:00;26;12;14;Leicht bewoelkt;10;10;0
30.09.2018 08:00;54;31;23;Leicht bewoelkt;12;12;0
30.09.2018 09:00;157;102;55;Leicht bewoelkt;14;14;0
30.09.2018 10:00;271;143;128;Leicht bewoelkt;16;16;0
30.09.2018 11:00;307;162;145;Leicht bewoelkt;17;17;0
30.09.2018 12:00;342;185;157;Leicht bewoelkt;19;19;0
30.09.2018 13:00;407;205;202;Leicht bewoelkt;20;20;0
30.09.2018 14:00;471;221;250;Leicht bewoelkt;20;20;0
30.09.2018 15:00;489;276;213;Leicht bewoelkt;21;21;0
30.09.2018 16:00;517;238;279;Leicht bewoelkt;20;20;0
30.09.2018 17:00;496;235;261;Leicht bewoelkt;19;19;0
30.09.2018 18:00;393;176;217;Leicht bewoelkt;18;18;0
30.09.2018 19:00;278;125;153;Leicht bewoelkt;17;17;0
30.09.2018 20:00;210;90;120;Leicht bewoelkt;16;15;0
30.09.2018 21:00;114;38;76;Leicht bewoelkt;14;14;0
30.09.2018 22:00;90;28;62;Leicht bewoelkt;14;13;0
30.09.2018 23:00;50;17;33;Nieselregen;13;12;0
01.10.2018 00:00;25;9;16;Nieselregen;12;12;1
01.10.2018 01:00;17;8;9;Nieselregen;12;11;1
01.10.2018 02:00;3;1;2;Leichter Regenfall;12;11;1
01.10.2018 03:00;3;1;2;Leichter Regenfall;12;10;1
01.10.2018 04:00;2;1;1;Leichter Regenfall;12;10;2
01.10.2018 05:00;18;10;8;Maessiger Regenfall;11;10;3
01.10.2018 06:00;86;46;40;Maessiger Regenfall;11;10;3
01.10.2018 07:00;566;347;219;Maessiger Regenfall;11;9;3
01.10.2018 08:00;426;257;169;Starker Regenfall;11;9;3
01.10.2018 09:00;402;281;121;Starker Regenfall;11;9;2
01.10.2018 10:00;234;136;98;Starker Regenfall;11;9;2
01.10.2018 11:00;343;178;165;Maessiger Regenfall;11;9;1
01.10.2018 12:00;449;200;249;Maessiger Regenfall;11;10;1
01.10.2018 13:00;614;254;360;Maessiger Regenfall;11;10;1
01.10.2018 14:00;413;200;213;Maessiger Regenfall;10;10;1
01.10.2018 15:00;677;316;361;Maessiger Regenfall;10;10;1
01.10.2018 16:00;565;285;280;Maessiger Regenfall;10;9;1
01.10.2018 17:00;703;318;385;Leichter Regenschauer;9;9;1
01.10.2018 18:00;581;266;315;Leichter Regenschauer;9;8;1
01.10.2018 19:00;459;222;237;Leichter Regenschauer;8;8;1
01.10.2018 20:00;276;124;152;Maessiger bis starker Regenschauer;8;7;1
01.10.2018 21:00;205;64;141;Maessiger bis starker Regenschauer;8;7;0
01.10.2018 22:00;155;66;89;Maessiger bis starker Regenschauer;7;7;0
01.10.2018 23:00;108;37;71;Stellenweiser Regenfall;7;7;0
02.10.2018 00:00;47;14;33;Stellenweiser Regenfall;7;7;0
02.10.2018 01:00;20;1;19;Stellenweiser Regenfall;6;6;0
02.10.2018 02:00;10;1;9;Leichter Regenschauer;6;5;0
02.10.2018 03:00;5;1;4;Leichter Regenschauer;5;5;0
02.10.2018 04:00;5;2;3;Leichter Regenschauer;5;5;0
02.10.2018 05:00;37;23;14;Leicht bewoelkt;5;5;0
02.10.2018 06:00;132;72;60;Leicht bewoelkt;5;5;0
02.10.2018 07:00;997;682;315;Leicht bewoelkt;6;5;0
02.10.2018 08:00;715;423;292;Stellenweiser Regenfall;7;6;0
02.10.2018 09:00;629;374;255;Stellenweiser Regenfall;8;7;0
02.10.2018 10:00;415;223;192;Stellenweiser Regenfall;9;8;0
02.10.2018 11:00;604;292;312;Leicht bewoelkt;10;9;0
02.10.2018 12:00;649;270;379;Leicht bewoelkt;11;10;0
02.10.2018 13:00;938;345;593;Leicht bewoelkt;11;10;0
02.10.2018 14:00;587;253;334;Stellenweiser Regenfall;12;10;0
02.10.2018 15:00;972;420;552;Stellenweiser Regenfall;12;11;0
02.10.2018 16:00;779;383;396;Stellenweiser Regenfall;12;11;0
02.10.2018 17:00;984;461;523;Bewoelkt;12;10;0
02.10.2018 18:00;746;350;396;Bewoelkt;12;10;0
02.10.2018 19:00;651;275;376;Bewoelkt;10;9;0
02.10.2018 20:00;419;217;202;Bewoelkt;9;9;0
02.10.2018 21:00;256;116;140;Bewoelkt;8;8;0
02.10.2018 22:00;215;88;127;Bewoelkt;9;8;0
02.10.2018 23:00;150;50;100;Stellenweiser Regenfall;9;8;0
03.10.2018 00:00;134;46;88;Stellenweiser Regenfall;9;8;0
03.10.2018 01:00;105;32;73;Stellenweiser Regenfall;9;8;0
03.10.2018 02:00;73;27;46;Nieselregen;10;9;0
03.10.2018 03:00;31;10;21;Nieselregen;10;9;0
03.10.2018 04:00;21;10;11;Nieselregen;10;9;0
03.10.2018 05:00;32;19;13;Bedeckt;10;9;0
03.10.2018 06:00;42;35;7;Bedeckt;10;9;0
03.10.2018 07:00;74;54;20;Bedeckt;11;9;0
03.10.2018 08:00;82;51;31;Bewoelkt;11;10;0
03.10.2018 09:00;154;84;70;Bewoelkt;11;10;0
03.10.2018 10:00;155;86;69;Bewoelkt;11;11;0
03.10.2018 11:00;172;84;88;Nieselregen;12;11;0
03.10.2018 12:00;236;124;112;Nieselregen;12;12;0
03.10.2018 13:00;270;123;147;Nieselregen;13;12;0
03.10.2018 14:00;305;142;163;Stellenweiser Regenfall;13;13;0
03.10.2018 15:00;346;188;158;Stellenweiser Regenfall;14;14;0
03.10.2018 16:00;356;190;166;Stellenweiser Regenfall;13;13;0
03.10.2018 17:00;399;168;231;Bedeckt;13;13;0
03.10.2018 18:00;381;163;218;Bedeckt;12;13;0
03.10.2018 19:00;336;144;192;Bedeckt;12;12;0
03.10.2018 20:00;212;100;112;Bewoelkt;11;11;0
03.10.2018 21:00;156;57;99;Bewoelkt;10;11;0
03.10.2018 22:00;148;45;103;Bewoelkt;10;10;0
03.10.2018 23:00;112;49;63;Leicht bewoelkt;10;9;0
04.10.2018 00:00;51;10;41;Leicht bewoelkt;9;9;0
04.10.2018 01:00;21;7;14;Leicht bewoelkt;9;8;0
04.10.2018 02:00;9;6;3;Leicht bewoelkt;9;8;0
04.10.2018 03:00;4;3;1;Leicht bewoelkt;8;8;0
04.10.2018 04:00;6;6;0;Leicht bewoelkt;8;7;0
04.10.2018 05:00;29;15;14;Leicht bewoelkt;8;7;0
04.10.2018 06:00;110;61;49;Leicht bewoelkt;8;7;0
04.10.2018 07:00;1006;675;331;Leicht bewoelkt;9;8;0
04.10.2018 08:00;666;337;329;Leicht bewoelkt;11;10;0
04.10.2018 09:00;684;478;206;Leicht bewoelkt;12;11;0
04.10.2018 10:00;446;250;196;Leicht bewoelkt;14;13;0
04.10.2018 11:00;647;296;351;Sonnig;15;15;0
04.10.2018 12:00;640;264;376;Sonnig;17;17;0
04.10.2018 13:00;999;435;564;Sonnig;17;17;0
04.10.2018 14:00;607;298;309;Sonnig;17;17;0
04.10.2018 15:00;1026;448;578;Sonnig;18;18;0
04.10.2018 16:00;903;447;456;Sonnig;17;17;0
04.10.2018 17:00;1071;494;577;Sonnig;16;16;0
04.10.2018 18:00;834;364;470;Sonnig;15;15;0
04.10.2018 19:00;657;322;335;Sonnig;14;14;0
04.10.2018 20:00;403;180;223;Sonnig;13;13;0
04.10.2018 21:00;262;88;174;Sonnig;12;13;0
04.10.2018 22:00;207;65;142;Sonnig;12;12;0
04.10.2018 23:00;114;37;77;Sonnig;12;12;0
05.10.2018 00:00;70;30;40;Sonnig;12;12;0
05.10.2018 01:00;36;13;23;Sonnig;11;11;0
05.10.2018 02:00;25;19;6;Leicht bewoelkt;11;11;0
05.10.2018 03:00;12;10;2;Leicht bewoelkt;11;11;0
05.10.2018 04:00;4;2;2;Leicht bewoelkt;11;11;0
05.10.2018 05:00;33;18;15;Sonnig;11;11;0
05.10.2018 06:00;119;70;49;Sonnig;10;10;0
05.10.2018 07:00;912;628;284;Sonnig;12;12;0
05.10.2018 08:00;595;330;265;Sonnig;14;14;0
05.10.2018 09:00;581;376;205;Sonnig;16;16;0
05.10.2018 10:00;467;242;225;Sonnig;18;18;0
05.10.2018 11:00;783;350;433;Sonnig;20;20;0
05.10.2018 12:00;665;252;413;Sonnig;22;22;0
05.10.2018 13:00;891;350;541;Sonnig;22;24;0
05.10.2018 14:00;687;333;354;Sonnig;23;24;0
05.10.2018 15:00;804;429;375;Sonnig;23;25;0
05.10.2018 16:00;731;359;372;Sonnig;22;24;0
05.10.2018 17:00;783;351;432;Leicht bewoelkt;21;21;0
05.10.2018 18:00;807;339;468;Leicht bewoelkt;20;20;0
05.10.2018 19:00;636;347;289;Leicht bewoelkt;19;19;0
05.10.2018 20:00;378;164;214;Leicht bewoelkt;18;18;0
05.10.2018 21:00;327;148;179;Leicht bewoelkt;16;17;0
05.10.2018 22:00;298;91;207;Leicht bewoelkt;15;15;0
05.10.2018 23:00;192;41;151;Leicht bewoelkt;14;14;0
06.10.2018 00:00;175;39;136;Leicht bewoelkt;13;13;0
06.10.2018 01:00;112;23;89;Leicht bewoelkt;12;12;0
06.10.2018 02:00;53;14;39;Leicht bewoelkt;12;12;0
06.10.2018 03:00;52;13;39;Leicht bewoelkt;11;11;0
06.10.2018 04:00;19;6;13;Leicht bewoelkt;11;11;0
06.10.2018 05:00;23;9;14;Leicht bewoelkt;11;11;0
06.10.2018 06:00;29;18;11;Leicht bewoelkt;11;10;0
06.10.2018 07:00;55;26;29;Leicht bewoelkt;12;12;0
06.10.2018 08:00;160;87;73;Leicht bewoelkt;14;14;0
06.10.2018 09:00;282;172;110;Leicht bewoelkt;16;16;0
06.10.2018 10:00;330;181;149;Leicht bewoelkt;17;17;0
06.10.2018 11:00;447;210;237;Leicht bewoelkt;19;19;0
06.10.2018 12:00;511;272;239;Leicht bewoelkt;20;20;0
06.10.2018 13:00;526;286;240;Leicht bewoelkt;21;21;0
06.10.2018 14:00;565;308;257;Leicht bewoelkt;21;21;0
06.10.2018 15:00;569;298;271;Leicht bewoelkt;21;21;0
06.10.2018 16:00;547;244;303;Leicht bewoelkt;20;20;0
06.10.2018 17:00;592;243;349;Leicht bewoelkt;20;20;0
06.10.2018 18:00;472;206;266;Leicht bewoelkt;19;19;0
06.10.2018 19:00;393;179;214;Leicht bewoelkt;18;18;0
06.10.2018 20:00;266;118;148;Leicht bewoelkt;17;17;0
06.10.2018 21:00;191;98;93;Leicht bewoelkt;17;17;0
06.10.2018 22:00;186;69;117;Leicht bewoelkt;16;16;0
06.10.2018 23:00;151;47;104;Leicht bewoelkt;14;15;0
07.10.2018 00:00;104;33;71;Leicht bewoelkt;13;13;0
07.10.2018 01:00;86;23;63;Leicht bewoelkt;13;13;0
07.10.2018 02:00;56;8;48;Leicht bewoelkt;12;12;0
07.10.2018 03:00;42;12;30;Leicht bewoelkt;11;11;0
07.10.2018 04:00;18;7;11;Leicht bewoelkt;11;11;0
07.10.2018 05:00;12;7;5;Leicht bewoelkt;11;11;0
07.10.2018 06:00;19;7;12;Leicht bewoelkt;11;11;0
07.10.2018 07:00;37;23;14;Leicht bewoelkt;12;12;0
07.10.2018 08:00;61;27;34;Leicht bewoelkt;14;14;0
07.10.2018 09:00;178;78;100;Leicht bewoelkt;15;15;0
07.10.2018 10:00;228;116;112;Leicht bewoelkt;16;16;0
07.10.2018 11:00;279;122;157;Leicht bewoelkt;18;18;0
07.10.2018 12:00;377;176;201;Leicht bewoelkt;19;19;0
07.10.2018 13:00;435;191;244;Leicht bewoelkt;19;19;0
07.10.2018 14:00;442;206;236;Leicht bewoelkt;19;19;0
07.10.2018 15:00;472;245;227;Leicht bewoelkt;20;20;0
07.10.2018 16:00;431;227;204;Leicht bewoelkt;18;18;0
07.10.2018 17:00;467;252;215;Stellenweiser Regenfall;17;17;0
07.10.2018 18:00;433;225;208;Stellenweiser Regenfall;16;16;0
07.10.2018 19:00;308;154;154;Stellenweiser Regenfall;15;15;0
07.10.2018 20:00;191;80;111;Leicht bewoelkt;14;14;0
07.10.2018 21:00;111;51;60;Leicht bewoelkt;13;13;0
07.10.2018 22:00;111;54;57;Leicht bewoelkt;13;13;0
07.10.2018 23:00;68;25;43;Leicht bewoelkt;13;12;0
08.10.2018 00:00;21;10;11;Leicht bewoelkt;12;12;0
08.10.2018 01:00;18;3;15;Leicht bewoelkt;12;12;0
08.10.2018 02:00;4;1;3;Leichter Nebel;12;11;0
08.10.2018 03:00;2;1;1;Leichter Nebel;11;11;0
08.10.2018 04:00;5;5;0;Leichter Nebel;11;11;0
08.10.2018 05:00;30;14;16;Leicht bewoelkt;11;10;0
08.10.2018 06:00;134;71;63;Leicht bewoelkt;10;10;0
08.10.2018 07:00;1064;707;357;Leicht bewoelkt;12;11;0
08.10.2018 08:00;656;352;304;Leicht bewoelkt;13;13;0
08.10.2018 09:00;675;459;216;Leicht bewoelkt;14;14;0
08.10.2018 10:00;408;225;183;Leicht bewoelkt;16;15;0
08.10.2018 11:00;627;289;338;Leicht bewoelkt;17;17;0
08.10.2018 12:00;586;274;312;Leicht bewoelkt;19;19;0
08.10.2018 13:00;1008;446;562;Leicht bewoelkt;19;19;0
08.10.2018 14:00;699;347;352;Leicht bewoelkt;19;19;0
08.10.2018 15:00;1082;453;629;Leicht bewoelkt;20;20;0
08.10.2018 16:00;927;427;500;Leicht bewoelkt;19;19;0
08.10.2018 17:00;1105;462;643;Leicht bewoelkt;18;18;0
08.10.2018 18:00;852;393;459;Leicht bewoelkt;18;18;0
08.10.2018 19:00;615;268;347;Leicht bewoelkt;16;16;0
08.10.2018 20:00;403;182;221;Leicht bewoelkt;15;15;0
08.10.2018 21:00;278;114;164;Leicht bewoelkt;14;14;0
08.10.2018 22:00;214;93;121;Leicht bewoelkt;13;14;0
08.10.2018 23:00;128;35;93;Leicht bewoelkt;13;13;0
09.10.2018 00:00;90;33;57;Leicht bewoelkt;12;12;0
09.10.2018 01:00;30;7;23;Leicht bewoelkt;12;12;0
09.10.2018 02:00;20;10;10;Leicht bewoelkt;11;11;0
09.10.2018 03:00;5;4;1;Leicht bewoelkt;11;11;0
09.10.2018 04:00;9;7;2;Leicht bewoelkt;10;11;0
09.10.2018 05:00;35;23;12;Leichter Nebel;10;11;0
09.10.2018 06:00;145;75;70;Leichter Nebel;10;10;0
09.10.2018 07:00;1144;776;368;Leichter Nebel;11;11;0
09.10.2018 08:00;790;460;330;Leicht bewoelkt;12;13;0
09.10.2018 09:00;703;449;254;Leicht bewoelkt;13;14;0
09.10.2018 10:00;428;222;206;Leicht bewoelkt;15;15;0
09.10.2018 11:00;612;266;346;Leicht bewoelkt;16;16;0
09.10.2018 12:00;614;248;366;Leicht bewoelkt;17;17;0
09.10.2018 13:00;912;383;529;Leicht bewoelkt;18;18;0
09.10.2018 14:00;576;264;312;Leicht bewoelkt;18;18;0
09.10.2018 15:00;1014;493;521;Leicht bewoelkt;19;19;0
09.10.2018 16:00;908;437;471;Leicht bewoelkt;18;18;0
09.10.2018 17:00;1125;468;657;Leicht bewoelkt;18;18;0
09.10.2018 18:00;879;379;500;Leicht bewoelkt;18;18;0
09.10.2018 19:00;723;313;410;Leicht bewoelkt;16;16;0
09.10.2018 20:00;363;150;213;Leichter Nebel;15;15;0
09.10.2018 21:00;269;97;172;Leichter Nebel;14;14;0
09.10.2018 22:00;261;87;174;Leichter Nebel;13;13;0
09.10.2018 23:00;109;50;59;Leicht bewoelkt;13;13;0
10.10.2018 00:00;46;18;28;Leicht bewoelkt;12;12;0
10.10.2018 01:00;34;11;23;Leicht bewoelkt;12;12;0
10.10.2018 02:00;7;6;1;Leicht bewoelkt;12;12;0
10.10.2018 03:00;2;1;1;Leicht bewoelkt;11;11;0
10.10.2018 04:00;2;2;0;Leicht bewoelkt;11;11;0
10.10.2018 05:00;41;19;22;Leicht bewoelkt;11;11;0
10.10.2018 06:00;128;62;66;Leicht bewoelkt;11;11;0
10.10.2018 07:00;1220;838;382;Leicht bewoelkt;13;13;0
10.10.2018 08:00;760;451;309;Leicht bewoelkt;14;14;0
10.10.2018 09:00;698;430;268;Leicht bewoelkt;16;16;0
10.10.2018 10:00;414;199;215;Leicht bewoelkt;18;18;0
10.10.2018 11:00;669;249;420;Sonnig;19;19;0
10.10.2018 12:00;649;297;352;Sonnig;21;21;0
10.10.2018 13:00;1061;504;557;Sonnig;21;21;0
10.10.2018 14:00;628;290;338;Sonnig;21;21;0
10.10.2018 15:00;947;449;498;Sonnig;21;21;0
10.10.2018 16:00;907;426;481;Sonnig;20;20;0
10.10.2018 17:00;1187;480;707;Leicht bewoelkt;19;19;0
10.10.2018 18:00;911;438;473;Leicht bewoelkt;18;18;0
10.10.2018 19:00;666;321;345;Leicht bewoelkt;17;17;0
10.10.2018 20:00;453;192;261;Leicht bewoelkt;16;16;0
10.10.2018 21:00;290;115;175;Leicht bewoelkt;15;15;0
10.10.2018 22:00;263;104;159;Leicht bewoelkt;14;14;0
10.10.2018 23:00;177;56;121;Sonnig;14;14;0
11.10.2018 00:00;89;27;62;Sonnig;13;13;0
11.10.2018 01:00;41;12;29;Sonnig;13;13;0
11.10.2018 02:00;27;6;21;Leicht bewoelkt;13;13;0
11.10.2018 03:00;10;1;9;Leicht bewoelkt;13;13;0
11.10.2018 04:00;5;4;1;Leicht bewoelkt;12;13;0
11.10.2018 05:00;32;19;13;Leicht bewoelkt;12;12;0
11.10.2018 06:00;136;76;60;Leicht bewoelkt;12;12;0
11.10.2018 07:00;1137;766;371;Leicht bewoelkt;13;13;0
11.10.2018 08:00;690;385;305;Leicht bewoelkt;14;14;0
11.10.2018 09:00;646;423;223;Leicht bewoelkt;15;15;0
11.10.2018 10:00;454;243;211;Leicht bewoelkt;15;15;0
11.10.2018 11:00;627;294;333;Leicht bewoelkt;16;16;0
11.10.2018 12:00;628;256;372;Leicht bewoelkt;17;17;0
11.10.2018 13:00;1083;437;646;Leicht bewoelkt;17;17;0
11.10.2018 14:00;669;324;345;Bewoelkt;17;17;0
11.10.2018 15:00;1072;464;608;Bewoelkt;17;17;0
11.10.2018 16:00;922;409;513;Bewoelkt;17;17;0
11.10.2018 17:00;1021;401;620;Leicht bewoelkt;16;16;0
11.10.2018 18:00;795;353;442;Leicht bewoelkt;15;15;0
11.10.2018 19:00;582;298;284;Leicht bewoelkt;15;15;0
11.10.2018 20:00;361;193;168;Leicht bewoelkt;14;14;0
11.10.2018 21:00;290;117;173;Leicht bewoelkt;13;13;0
11.10.2018 22:00;271;111;160;Leicht bewoelkt;13;13;0
11.10.2018 23:00;164;92;72;Leicht bewoelkt;12;13;0
12.10.2018 00:00;70;12;58;Leicht bewoelkt;12;12;0
12.10.2018 01:00;70;11;59;Leicht bewoelkt;12;12;0
12.10.2018 02:00;50;6;44;Leicht bewoelkt;12;12;0
12.10.2018 03:00;59;3;56;Leicht bewoelkt;12;12;0
12.10.2018 04:00;17;8;9;Leicht bewoelkt;12;12;0
12.10.2018 05:00;45;25;20;Leicht bewoelkt;11;12;0
12.10.2018 06:00;135;77;58;Leicht bewoelkt;11;12;0
12.10.2018 07:00;943;615;328;Leicht bewoelkt;13;13;0
12.10.2018 08:00;693;395;298;Leicht bewoelkt;15;15;0
12.10.2018 09:00;650;428;222;Leicht bewoelkt;16;16;0
12.10.2018 10:00;454;257;197;Leicht bewoelkt;18;18;0
12.10.2018 11:00;613;265;348;Leicht bewoelkt;20;20;0
12.10.2018 12:00;693;309;384;Leicht bewoelkt;22;22;0
12.10.2018 13:00;1092;404;688;Leicht bewoelkt;22;24;0
12.10.2018 14:00;704;372;332;Leicht bewoelkt;23;24;0
12.10.2018 15:00;766;364;402;Leicht bewoelkt;23;25;0
12.10.2018 16:00;763;334;429;Leicht bewoelkt;23;24;0
12.10.2018 17:00;798;339;459;Sonnig;22;22;0
12.10.2018 18:00;720;335;385;Sonnig;21;21;0
12.10.2018 19:00;535;250;285;Sonnig;20;20;0
12.10.2018 20:00;380;168;212;Sonnig;18;18;0
12.10.2018 21:00;242;119;123;Sonnig;17;17;0
12.10.2018 22:00;218;100;118;Sonnig;16;16;0
12.10.2018 23:00;201;59;142;Sonnig;16;16;0
13.10.2018 00:00;138;44;94;Sonnig;15;15;0
13.10.2018 01:00;111;42;69;Sonnig;15;15;0
13.10.2018 02:00;61;26;35;Sonnig;15;15;0
13.10.2018 03:00;39;10;29;Sonnig;15;15;0
13.10.2018 04:00;20;11;9;Sonnig;14;14;0
13.10.2018 05:00;25;14;11;Sonnig;14;14;0
13.10.2018 06:00;46;30;16;Sonnig;14;14;0
13.10.2018 07:00;67;39;28;Sonnig;15;15;0
13.10.2018 08:00;165;110;55;Sonnig;17;17;0
13.10.2018 09:00;291;172;119;Sonnig;18;18;0
13.10.2018 10:00;379;216;163;Sonnig;19;19;0
13.10.2018 11:00;454;240;214;Sonnig;21;21;0
13.10.2018 12:00;546;292;254;Sonnig;22;23;0
13.10.2018 13:00;650;344;306;Sonnig;22;24;0
13.10.2018 14:00;638;310;328;Sonnig;22;24;0
13.10.2018 15:00;598;308;290;Sonnig;22;25;0
13.10.2018 16:00;543;260;283;Sonnig;21;21;0
13.10.2018 17:00;622;300;322;Leicht bewoelkt;20;20;0
13.10.2018 18:00;581;226;355;Leicht bewoelkt;19;19;0
13.10.2018 19:00;457;214;243;Leicht bewoelkt;18;18;0
13.10.2018 20:00;348;182;166;Leicht bewoelkt;17;17;0
13.10.2018 21:00;214;124;90;Leicht bewoelkt;16;16;0
13.10.2018 22:00;252;114;138;Leicht bewoelkt;15;15;0
13.10.2018 23:00;205;89;116;Leicht bewoelkt;14;15;0
14.10.2018 00:00;178;72;106;Leicht bewoelkt;14;14;0
14.10.2018 01:00;112;35;77;Leicht bewoelkt;14;14;0
14.10.2018 02:00;67;16;51;Leicht bewoelkt;14;14;0
14.10.2018 03:00;56;14;42;Leicht bewoelkt;14;14;0
14.10.2018 04:00;25;7;18;Leicht bewoelkt;13;13;0
14.10.2018 05:00;29;6;23;Sonnig;13;13;0
14.10.2018 06:00;35;19;16;Sonnig;13;13;0
14.10.2018 07:00;44;22;22;Sonnig;14;14;0
14.10.2018 08:00;92;57;35;Sonnig;16;16;0
14.10.2018 09:00;158;92;66;Sonnig;17;17;0
14.10.2018 10:00;222;120;102;Sonnig;19;19;0
14.10.2018 11:00;285;148;137;Sonnig;21;21;0
14.10.2018 12:00;428;219;209;Sonnig;23;24;0
14.10.2018 13:00;559;312;247;Sonnig;23;24;0
14.10.2018 14:00;679;396;283;Sonnig;22;24;0
14.10.2018 15:00;574;339;235;Sonnig;22;25;0
14.10.2018 16:00;594;269;325;Sonnig;21;21;0
14.10.2018 17:00;627;256;371;Leicht bewoelkt;20;20;0
14.10.2018 18:00;576;211;365;Leicht bewoelkt;19;19;0
14.10.2018 19:00;343;160;183;Leicht bewoelkt;18;18;0
14.10.2018 20:00;217;89;128;Leicht bewoelkt;17;17;0
14.10.2018 21:00;139;46;93;Leicht bewoelkt;16;16;0
14.10.2018 22:00;135;53;82;Leicht bewoelkt;15;15;0
14.10.2018 23:00;85;28;57;Leicht bewoelkt;13;13;0
15.10.2018 00:00;42;19;23;Leicht bewoelkt;12;12;0
15.10.2018 01:00;16;6;10;Leicht bewoelkt;12;12;0
15.10.2018 02:00;2;2;0;Leicht bewoelkt;12;12;0
15.10.2018 03:00;1;1;0;Leicht bewoelkt;11;11;0
15.10.2018 04:00;6;3;3;Leicht bewoelkt;11;11;0
15.10.2018 05:00;34;20;14;Leicht bewoelkt;11;11;0
15.10.2018 06:00;151;82;69;Leicht bewoelkt;11;11;0
15.10.2018 07:00;992;645;347;Leicht bewoelkt;12;12;0
15.10.2018 08:00;723;397;326;Leicht bewoelkt;14;14;0
15.10.2018 09:00;753;489;264;Leicht bewoelkt;16;16;0
15.10.2018 10:00;400;229;171;Leicht bewoelkt;18;18;0
15.10.2018 11:00;622;294;328;Leicht bewoelkt;20;20;0
15.10.2018 12:00;611;292;319;Leicht bewoelkt;21;21;0
15.10.2018 13:00;949;401;548;Leicht bewoelkt;21;21;0
15.10.2018 14:00;657;321;336;Leicht bewoelkt;21;21;0
15.10.2018 15:00;990;433;557;Leicht bewoelkt;21;21;0
15.10.2018 16:00;878;430;448;Leicht bewoelkt;20;20;0
15.10.2018 17:00;1194;518;676;Leicht bewoelkt;19;19;0
15.10.2018 18:00;933;400;533;Leicht bewoelkt;19;19;0
15.10.2018 19:00;704;338;366;Leicht bewoelkt;17;17;0
15.10.2018 20:00;437;208;229;Leicht bewoelkt;16;16;0
15.10.2018 21:00;304;122;182;Leicht bewoelkt;15;15;0
15.10.2018 22:00;246;88;158;Leicht bewoelkt;14;14;0
15.10.2018 23:00;114;34;80;Leicht bewoelkt;13;13;0
16.10.2018 00:00;73;25;48;Leicht bewoelkt;13;13;0
16.10.2018 01:00;37;12;25;Leicht bewoelkt;12;12;0
16.10.2018 02:00;18;6;12;Leicht bewoelkt;12;12;0
16.10.2018 03:00;13;5;8;Leicht bewoelkt;11;12;0
16.10.2018 04:00;8;5;3;Leicht bewoelkt;11;11;0
16.10.2018 05:00;39;25;14;Leicht bewoelkt;11;11;0
16.10.2018 06:00;129;69;60;Leicht bewoelkt;10;11;0
16.10.2018 07:00;1104;750;354;Leicht bewoelkt;12;12;0
16.10.2018 08:00;799;455;344;Leicht bewoelkt;13;14;0
16.10.2018 09:00;734;468;266;Leicht bewoelkt;15;15;0
16.10.2018 10:00;394;220;174;Leicht bewoelkt;17;17;0
16.10.2018 11:00;661;314;347;Leicht bewoelkt;18;18;0
16.10.2018 12:00;603;265;338;Leicht bewoelkt;20;20;0
16.10.2018 13:00;1010;416;594;Leicht bewoelkt;20;20;0
16.10.2018 14:00;608;271;337;Leicht bewoelkt;20;20;0
16.10.2018 15:00;1011;472;539;Leicht bewoelkt;21;21;0
16.10.2018 16:00;939;447;492;Leicht bewoelkt;20;20;0
16.10.2018 17:00;1157;527;630;Leicht bewoelkt;19;19;0
16.10.2018 18:00;898;393;505;Leicht bewoelkt;18;18;0
16.10.2018 19:00;782;344;438;Leicht bewoelkt;17;17;0
16.10.2018 20:00;409;187;222;Leicht bewoelkt;16;16;0
16.10.2018 21:00;287;113;174;Leicht bewoelkt;15;15;0
16.10.2018 22:00;231;89;142;Leicht bewoelkt;14;14;0
16.10.2018 23:00;165;55;110;Leicht bewoelkt;13;13;0
17.10.2018 00:00;64;29;35;Leicht bewoelkt;12;12;0
17.10.2018 01:00;40;12;28;Leicht bewoelkt;11;11;0
17.10.2018 02:00;7;2;5;Leicht bewoelkt;11;11;0
17.10.2018 03:00;3;1;2;Leicht bewoelkt;10;10;0
17.10.2018 04:00;3;2;1;Leicht bewoelkt;10;10;0
17.10.2018 05:00;38;18;20;Leicht bewoelkt;10;10;0
17.10.2018 06:00;153;82;71;Leicht bewoelkt;10;10;0
17.10.2018 07:00;1205;814;391;Leicht bewoelkt;11;11;0
17.10.2018 08:00;984;619;365;Leicht bewoelkt;13;13;0
17.10.2018 09:00;975;651;324;Leicht bewoelkt;15;15;0
17.10.2018 10:00;498;279;219;Leicht bewoelkt;16;16;0
17.10.2018 11:00;684;262;422;Leicht bewoelkt;18;18;0
17.10.2018 12:00;711;325;386;Leicht bewoelkt;19;19;0
17.10.2018 13:00;1036;447;589;Leicht bewoelkt;19;19;0
17.10.2018 14:00;698;321;377;Leicht bewoelkt;19;19;0
17.10.2018 15:00;1004;458;546;Leicht bewoelkt;20;20;0
17.10.2018 16:00;924;447;477;Leicht bewoelkt;19;19;0
17.10.2018 17:00;1193;527;666;Leicht bewoelkt;18;18;0
17.10.2018 18:00;932;435;497;Leicht bewoelkt;17;17;0
17.10.2018 19:00;753;343;410;Leicht bewoelkt;16;16;0
17.10.2018 20:00;523;244;279;Leicht bewoelkt;15;15;0
17.10.2018 21:00;318;122;196;Leicht bewoelkt;14;14;0
17.10.2018 22:00;266;96;170;Leicht bewoelkt;13;13;0
17.10.2018 23:00;152;51;101;Leicht bewoelkt;12;12;0
18.10.2018 00:00;78;19;59;Leicht bewoelkt;11;11;0
18.10.2018 01:00;40;10;30;Leicht bewoelkt;11;11;0
18.10.2018 02:00;10;3;7;Leicht bewoelkt;11;10;0
18.10.2018 03:00;12;8;4;Leicht bewoelkt;11;10;0
18.10.2018 04:00;9;9;0;Leicht bewoelkt;10;10;0
18.10.2018 05:00;42;24;18;Leicht bewoelkt;10;10;0
18.10.2018 06:00;132;82;50;Leicht bewoelkt;10;9;0
18.10.2018 07:00;1015;661;354;Leicht bewoelkt;11;11;0
18.10.2018 08:00;786;468;318;Leicht bewoelkt;12;12;0
18.10.2018 09:00;732;493;239;Leicht bewoelkt;13;13;0
18.10.2018 10:00;415;232;183;Leicht bewoelkt;15;14;0
18.10.2018 11:00;628;296;332;Leicht bewoelkt;16;16;0
18.10.2018 12:00;658;251;407;Leicht bewoelkt;18;17;0
18.10.2018 13:00;939;409;530;Leicht bewoelkt;18;18;0
18.10.2018 14:00;640;300;340;Leicht bewoelkt;18;18;0
18.10.2018 15:00;929;442;487;Leicht bewoelkt;18;18;0
18.10.2018 16:00;885;434;451;Leicht bewoelkt;17;17;0
18.10.2018 17:00;1062;480;582;Leicht bewoelkt;16;15;0
18.10.2018 18:00;900;413;487;Leicht bewoelkt;15;14;0
18.10.2018 19:00;651;328;323;Leicht bewoelkt;14;13;0
18.10.2018 20:00;425;174;251;Leicht bewoelkt;13;12;0
18.10.2018 21:00;297;98;199;Leicht bewoelkt;12;11;0
18.10.2018 22:00;253;106;147;Leicht bewoelkt;12;10;0
18.10.2018 23:00;180;70;110;Leicht bewoelkt;11;10;0
19.10.2018 00:00;111;42;69;Leicht bewoelkt;11;10;0
19.10.2018 01:00;65;14;51;Leicht bewoelkt;10;9;0
19.10.2018 02:00;33;12;21;Leicht bewoelkt;10;9;0
19.10.2018 03:00;26;19;7;Leicht bewoelkt;10;9;0
19.10.2018 04:00;24;19;5;Leicht bewoelkt;9;8;0
19.10.2018 05:00;44;30;14;Leicht bewoelkt;9;8;0
19.10.2018 06:00;154;90;64;Leicht bewoelkt;9;8;0
19.10.2018 07:00;955;613;342;Leicht bewoelkt;10;9;0
19.10.2018 08:00;683;390;293;Leicht bewoelkt;11;10;0
19.10.2018 09:00;648;409;239;Leicht bewoelkt;12;12;0
19.10.2018 10:00;457;242;215;Leicht bewoelkt;14;13;0
19.10.2018 11:00;574;260;314;Leicht bewoelkt;15;15;0
19.10.2018 12:00;759;336;423;Leicht bewoelkt;16;16;0
19.10.2018 13:00;941;391;550;Leicht bewoelkt;17;17;0
19.10.2018 14:00;719;348;371;Leicht bewoelkt;17;17;0
19.10.2018 15:00;731;319;412;Leicht bewoelkt;17;17;0
19.10.2018 16:00;750;342;408;Leicht bewoelkt;17;17;0
19.10.2018 17:00;787;353;434;Leicht bewoelkt;16;16;0
19.10.2018 18:00;666;265;401;Leicht bewoelkt;15;15;0
19.10.2018 19:00;547;270;277;Leicht bewoelkt;14;14;0
19.10.2018 20:00;363;184;179;Leicht bewoelkt;13;13;0
19.10.2018 21:00;248;134;114;Leicht bewoelkt;12;12;0
19.10.2018 22:00;200;90;110;Leicht bewoelkt;11;11;0
19.10.2018 23:00;192;72;120;Leicht bewoelkt;10;10;0
20.10.2018 00:00;154;51;103;Leicht bewoelkt;10;10;0
20.10.2018 01:00;100;33;67;Leicht bewoelkt;9;10;0
20.10.2018 02:00;65;20;45;Leicht bewoelkt;9;9;0
20.10.2018 03:00;42;15;27;Leicht bewoelkt;9;9;0
20.10.2018 04:00;21;11;10;Leicht bewoelkt;9;9;0
20.10.2018 05:00;26;20;6;Leicht bewoelkt;9;9;0
20.10.2018 06:00;39;26;13;Leicht bewoelkt;8;8;0
20.10.2018 07:00;72;32;40;Leicht bewoelkt;10;10;0
20.10.2018 08:00;184;114;70;Leicht bewoelkt;11;11;0
20.10.2018 09:00;308;199;109;Leicht bewoelkt;12;12;0
20.10.2018 10:00;389;223;166;Leicht bewoelkt;13;14;0
20.10.2018 11:00;455;230;225;Leicht bewoelkt;15;15;0
20.10.2018 12:00;496;276;220;Leicht bewoelkt;16;16;0
20.10.2018 13:00;532;283;249;Leicht bewoelkt;16;16;0
20.10.2018 14:00;584;284;300;Leicht bewoelkt;16;17;0
20.10.2018 15:00;604;316;288;Leicht bewoelkt;17;17;0
20.10.2018 16:00;558;252;306;Leicht bewoelkt;16;16;0
20.10.2018 17:00;560;234;326;Leicht bewoelkt;16;16;0
20.10.2018 18:00;543;202;341;Leicht bewoelkt;15;15;0
20.10.2018 19:00;353;164;189;Leicht bewoelkt;14;14;0
20.10.2018 20:00;261;132;129;Leicht bewoelkt;12;12;0
20.10.2018 21:00;256;87;169;Leicht bewoelkt;11;11;0
20.10.2018 22:00;202;90;112;Leicht bewoelkt;11;10;0
20.10.2018 23:00;204;81;123;Leicht bewoelkt;10;9;0
21.10.2018 00:00;162;66;96;Leicht bewoelkt;9;8;0
21.10.2018 01:00;104;51;53;Leicht bewoelkt;9;8;0
21.10.2018 02:00;84;34;50;Leicht bewoelkt;9;8;0
21.10.2018 03:00;97;21;76;Leicht bewoelkt;8;8;0
21.10.2018 04:00;25;14;11;Leicht bewoelkt;8;7;0
21.10.2018 05:00;30;13;17;Leicht bewoelkt;7;7;0
21.10.2018 06:00;28;20;8;Leicht bewoelkt;7;7;0
21.10.2018 07:00;39;27;12;Leicht bewoelkt;8;7;0
21.10.2018 08:00;61;31;30;Leicht bewoelkt;9;8;0
21.10.2018 09:00;148;94;54;Leicht bewoelkt;10;9;0
21.10.2018 10:00;337;255;82;Leicht bewoelkt;11;10;0
21.10.2018 11:00;615;494;121;Leicht bewoelkt;13;12;0
21.10.2018 12:00;584;329;255;Leicht bewoelkt;14;13;0
21.10.2018 13:00;609;203;406;Leicht bewoelkt;14;13;0
21.10.2018 14:00;702;320;382;Leicht bewoelkt;14;13;0
21.10.2018 15:00;685;358;327;Leicht bewoelkt;14;13;0
21.10.2018 16:00;661;310;351;Leicht bewoelkt;13;12;0
21.10.2018 17:00;709;239;470;Leicht bewoelkt;12;12;0
21.10.2018 18:00;492;167;325;Leicht bewoelkt;12;11;0
21.10.2018 19:00;303;137;166;Leicht bewoelkt;10;10;0
21.10.2018 20:00;199;70;129;Sonnig;9;8;0
21.10.2018 21:00;143;61;82;Sonnig;8;7;0
21.10.2018 22:00;116;41;75;Sonnig;8;6;0
21.10.2018 23:00;74;32;42;Sonnig;7;6;0
22.10.2018 00:00;26;11;15;Sonnig;7;5;0
22.10.2018 01:00;10;5;5;Sonnig;6;5;0
22.10.2018 02:00;11;4;7;Sonnig;6;5;0
22.10.2018 03:00;3;1;2;Sonnig;6;4;0
22.10.2018 04:00;9;7;2;Sonnig;5;4;0
22.10.2018 05:00;37;27;10;Sonnig;5;4;0
22.10.2018 06:00;147;85;62;Sonnig;5;4;0
22.10.2018 07:00;1071;711;360;Sonnig;6;4;0
22.10.2018 08:00;686;377;309;Sonnig;7;5;0
22.10.2018 09:00;697;430;267;Sonnig;8;6;0
22.10.2018 10:00;416;237;179;Sonnig;9;8;0
22.10.2018 11:00;650;315;335;Sonnig;10;9;0
22.10.2018 12:00;638;295;343;Sonnig;12;10;0
22.10.2018 13:00;927;397;530;Sonnig;12;11;0
22.10.2018 14:00;629;326;303;Leicht bewoelkt;12;11;0
22.10.2018 15:00;1025;466;559;Leicht bewoelkt;13;11;0
22.10.2018 16:00;867;405;462;Leicht bewoelkt;12;10;0
22.10.2018 17:00;1110;514;596;Leicht bewoelkt;11;10;0
22.10.2018 18:00;891;400;491;Leicht bewoelkt;10;9;0
22.10.2018 19:00;652;293;359;Leicht bewoelkt;10;8;0
22.10.2018 20:00;402;186;216;Leicht bewoelkt;9;8;0
22.10.2018 21:00;322;125;197;Leicht bewoelkt;8;7;0
22.10.2018 22:00;212;87;125;Leicht bewoelkt;8;7;0
22.10.2018 23:00;130;38;92;Leicht bewoelkt;8;7;0
23.10.2018 00:00;62;24;38;Leicht bewoelkt;7;7;0
23.10.2018 01:00;37;10;27;Leicht bewoelkt;7;7;0
23.10.2018 02:00;10;3;7;Leicht bewoelkt;6;6;0
23.10.2018 03:00;7;4;3;Leicht bewoelkt;6;6;0
23.10.2018 04:00;11;4;7;Leicht bewoelkt;5;5;0
23.10.2018 05:00;41;23;18;Leicht bewoelkt;5;5;0
23.10.2018 06:00;146;87;59;Leicht bewoelkt;5;5;0
23.10.2018 07:00;1033;693;340;Leicht bewoelkt;6;6;0
23.10.2018 08:00;778;462;316;Leicht bewoelkt;7;7;0
23.10.2018 09:00;815;492;323;Leicht bewoelkt;8;8;0
23.10.2018 10:00;413;233;180;Leicht bewoelkt;10;9;0
23.10.2018 11:00;613;265;348;Leicht bewoelkt;11;10;0
23.10.2018 12:00;563;228;335;Leicht bewoelkt;12;12;0
23.10.2018 13:00;877;366;511;Leicht bewoelkt;13;12;0
23.10.2018 14:00;608;286;322;Leicht bewoelkt;13;12;0
23.10.2018 15:00;973;415;558;Leicht bewoelkt;13;13;0
23.10.2018 16:00;823;364;459;Leicht bewoelkt;13;13;0
23.10.2018 17:00;1048;502;546;Bedeckt;13;12;0
23.10.2018 18:00;851;371;480;Bedeckt;13;12;0
23.10.2018 19:00;676;296;380;Bedeckt;13;12;0
23.10.2018 20:00;388;156;232;Bewoelkt;13;12;0
23.10.2018 21:00;264;112;152;Bewoelkt;13;12;0
23.10.2018 22:00;259;81;178;Bewoelkt;12;11;0
23.10.2018 23:00;131;52;79;Bewoelkt;12;11;0
24.10.2018 00:00;74;29;45;Bewoelkt;11;10;0
24.10.2018 01:00;58;34;24;Bewoelkt;11;10;0
24.10.2018 02:00;25;19;6;Bedeckt;11;9;0
24.10.2018 03:00;12;8;4;Bedeckt;11;9;0
24.10.2018 04:00;4;3;1;Bedeckt;10;9;0
24.10.2018 05:00;32;23;9;Leicht bewoelkt;10;9;0
24.10.2018 06:00;147;82;65;Leicht bewoelkt;10;8;0
24.10.2018 07:00;1073;714;359;Leicht bewoelkt;10;8;0
24.10.2018 08:00;736;432;304;Bewoelkt;10;8;0
24.10.2018 09:00;717;428;289;Bewoelkt;10;8;0
24.10.2018 10:00;341;188;153;Bewoelkt;10;8;1
24.10.2018 11:00;531;207;324;Leichter Regenfall;10;8;1
24.10.2018 12:00;527;253;274;Leichter Regenfall;10;8;1
24.10.2018 13:00;836;372;464;Leichter Regenfall;11;9;0
24.10.2018 14:00;526;252;274;Leichter Regenfall;11;10;0
24.10.2018 15:00;861;406;455;Leichter Regenfall;11;10;0
24.10.2018 16:00;730;360;370;Leichter Regenfall;12;10;0
24.10.2018 17:00;1001;420;581;Stellenweiser Regenfall;12;11;0
24.10.2018 18:00;824;386;438;Stellenweiser Regenfall;12;11;0
24.10.2018 19:00;684;287;397;Stellenweiser Regenfall;12;11;0
24.10.2018 20:00;424;180;244;Bewoelkt;11;11;0
24.10.2018 21:00;330;131;199;Bewoelkt;11;11;0
24.10.2018 22:00;242;102;140;Bewoelkt;11;11;0
24.10.2018 23:00;186;77;109;Bewoelkt;11;11;0
25.10.2018 00:00;86;30;56;Bewoelkt;11;11;0
25.10.2018 01:00;31;16;15;Bewoelkt;10;10;0
25.10.2018 02:00;14;6;8;Bewoelkt;10;10;0
25.10.2018 03:00;15;11;4;Bewoelkt;10;10;0
25.10.2018 04:00;19;14;5;Bewoelkt;9;9;0
25.10.2018 05:00;41;31;10;Leicht bewoelkt;9;9;0
25.10.2018 06:00;138;78;60;Leicht bewoelkt;9;9;0
25.10.2018 07:00;1042;651;391;Leicht bewoelkt;10;10;0
25.10.2018 08:00;698;426;272;Leicht bewoelkt;11;11;0
25.10.2018 09:00;677;434;243;Leicht bewoelkt;11;12;0
25.10.2018 10:00;387;214;173;Leicht bewoelkt;13;13;0
25.10.2018 11:00;626;279;347;Leicht bewoelkt;14;14;0
25.10.2018 12:00;567;237;330;Leicht bewoelkt;16;16;0
25.10.2018 13:00;904;385;519;Leicht bewoelkt;17;17;0
25.10.2018 14:00;628;333;295;Sonnig;18;18;0
25.10.2018 15:00;1040;482;558;Sonnig;18;18;0
25.10.2018 16:00;905;413;492;Sonnig;18;18;0
25.10.2018 17:00;1041;406;635;Sonnig;18;18;0
25.10.2018 18:00;890;432;458;Sonnig;18;18;0
25.10.2018 19:00;690;361;329;Sonnig;17;17;0
25.10.2018 20:00;398;181;217;Leicht bewoelkt;16;16;0
25.10.2018 21:00;280;122;158;Leicht bewoelkt;16;16;0
25.10.2018 22:00;272;104;168;Leicht bewoelkt;14;14;0
25.10.2018 23:00;163;66;97;Sonnig;12;12;0
26.10.2018 00:00;80;31;49;Sonnig;11;11;0
26.10.2018 01:00;46;12;34;Sonnig;10;10;0
26.10.2018 02:00;22;6;16;Leicht bewoelkt;9;9;0
26.10.2018 03:00;21;10;11;Leicht bewoelkt;8;8;0
26.10.2018 04:00;12;10;2;Leicht bewoelkt;8;8;0
26.10.2018 05:00;30;19;11;Leicht bewoelkt;7;7;0
26.10.2018 06:00;143;91;52;Leicht bewoelkt;7;7;0
26.10.2018 07:00;892;570;322;Leicht bewoelkt;8;8;0
26.10.2018 08:00;649;378;271;Leicht bewoelkt;10;10;0
26.10.2018 09:00;649;400;249;Leicht bewoelkt;11;11;0
26.10.2018 10:00;386;211;175;Leicht bewoelkt;12;12;0
26.10.2018 11:00;572;258;314;Leicht bewoelkt;14;14;0
26.10.2018 12:00;716;321;395;Leicht bewoelkt;15;15;0
26.10.2018 13:00;865;356;509;Leicht bewoelkt;15;15;0
26.10.2018 14:00;636;298;338;Leicht bewoelkt;15;15;0
26.10.2018 15:00;699;340;359;Leicht bewoelkt;16;16;0
26.10.2018 16:00;742;389;353;Leicht bewoelkt;15;15;0
26.10.2018 17:00;803;345;458;Leicht bewoelkt;14;14;0
26.10.2018 18:00;692;335;357;Leicht bewoelkt;13;13;0
26.10.2018 19:00;503;242;261;Leicht bewoelkt;12;12;0
26.10.2018 20:00;332;158;174;Bewoelkt;11;11;0
26.10.2018 21:00;278;117;161;Bewoelkt;10;10;0
26.10.2018 22:00;209;94;115;Bewoelkt;10;10;0
26.10.2018 23:00;184;64;120;Bewoelkt;10;10;0
27.10.2018 00:00;137;51;86;Bewoelkt;9;9;0
27.10.2018 01:00;108;34;74;Bewoelkt;9;9;0
27.10.2018 02:00;67;26;41;Stellenweiser Regenfall;9;9;0
27.10.2018 03:00;44;14;30;Stellenweiser Regenfall;9;8;0
27.10.2018 04:00;19;14;5;Stellenweiser Regenfall;9;8;0
27.10.2018 05:00;23;13;10;Stellenweiser Regenfall;8;7;0
27.10.2018 06:00;22;14;8;Stellenweiser Regenfall;8;7;0
27.10.2018 07:00;28;13;15;Stellenweiser Regenfall;8;7;0
27.10.2018 08:00;84;42;42;Bedeckt;8;7;0
27.10.2018 09:00;145;91;54;Bedeckt;8;7;1
27.10.2018 10:00;144;74;70;Bedeckt;7;7;1
27.10.2018 11:00;137;76;61;Maessiger Regenfall;7;6;1
27.10.2018 12:00;198;90;108;Maessiger Regenfall;7;6;1
27.10.2018 13:00;166;95;71;Maessiger Regenfall;7;5;1
27.10.2018 14:00;184;87;97;Maessiger Regenfall;7;4;1
27.10.2018 15:00;171;90;81;Maessiger Regenfall;7;4;1
27.10.2018 16:00;186;90;96;Maessiger Regenfall;6;3;1
27.10.2018 17:00;190;96;94;Maessiger Regenfall;6;2;1
27.10.2018 18:00;246;102;144;Maessiger Regenfall;6;2;2
27.10.2018 19:00;191;104;87;Maessiger Regenfall;5;2;1
27.10.2018 20:00;158;74;84;Maessiger Regenfall;5;1;1
27.10.2018 21:00;160;50;110;Maessiger Regenfall;5;1;1
27.10.2018 22:00;101;50;51;Maessiger Regenfall;5;1;1
27.10.2018 23:00;96;30;66;Maessiger Regenfall;5;1;1
28.10.2018 00:00;110;43;67;Maessiger Regenfall;5;1;1
28.10.2018 01:00;75;42;33;Maessiger Regenfall;5;0;1
28.10.2018 02:00;110;65;45;Maessiger Regenfall;4;0;1
28.10.2018 03:00;28;14;14;Maessiger Regenfall;4;0;1
28.10.2018 04:00;19;9;10;Maessiger Regenfall;4;-1;1
28.10.2018 05:00;13;11;2;Maessiger bis starker Eisregen;4;-1;1
28.10.2018 06:00;17;10;7;Maessiger bis starker Eisregen;4;-1;0
28.10.2018 07:00;21;13;8;Maessiger bis starker Eisregen;4;-1;0
28.10.2018 08:00;44;16;28;Bedeckt;4;0;1
28.10.2018 09:00;105;67;38;Bedeckt;4;0;1
28.10.2018 10:00;129;62;67;Bedeckt;4;0;1
28.10.2018 11:00;154;77;77;Maessiger Regenfall;4;0;0
28.10.2018 12:00;160;78;82;Maessiger Regenfall;5;1;0
28.10.2018 13:00;149;67;82;Maessiger Regenfall;4;1;0
28.10.2018 14:00;162;82;80;Bedeckt;4;1;0
28.10.2018 15:00;158;86;72;Bedeckt;4;1;0
28.10.2018 16:00;170;90;80;Bedeckt;4;0;0
28.10.2018 17:00;148;73;75;Nieselregen;4;0;0
28.10.2018 18:00;130;65;65;Nieselregen;4;0;0
28.10.2018 19:00;143;74;69;Nieselregen;4;0;0
28.10.2018 20:00;109;47;62;Bedeckt;4;0;0
28.10.2018 21:00;77;27;50;Bedeckt;4;0;0
28.10.2018 22:00;70;33;37;Bedeckt;4;0;0
28.10.2018 23:00;49;21;28;Bewoelkt;4;1;0
29.10.2018 00:00;16;9;7;Bewoelkt;4;1;0
29.10.2018 01:00;16;8;8;Bewoelkt;4;1;0
29.10.2018 02:00;7;3;4;Leicht bewoelkt;4;1;0
29.10.2018 03:00;3;3;0;Leicht bewoelkt;4;1;0
29.10.2018 04:00;0;0;0;Leicht bewoelkt;4;0;0
29.10.2018 05:00;34;18;16;Bedeckt;4;0;0
29.10.2018 06:00;134;91;43;Bedeckt;4;0;0
29.10.2018 07:00;460;305;155;Bedeckt;4;1;0
29.10.2018 08:00;543;296;247;Bewoelkt;5;1;0
29.10.2018 09:00;554;385;169;Bewoelkt;5;2;0
29.10.2018 10:00;367;216;151;Bewoelkt;7;3;0
29.10.2018 11:00;461;227;234;Bewoelkt;8;5;0
29.10.2018 12:00;442;209;233;Bewoelkt;9;6;0
29.10.2018 13:00;491;225;266;Bewoelkt;10;7;0
29.10.2018 14:00;413;206;207;Leicht bewoelkt;10;8;0
29.10.2018 15:00;515;225;290;Leicht bewoelkt;11;9;0
29.10.2018 16:00;567;250;317;Leicht bewoelkt;11;9;0
29.10.2018 17:00;691;290;401;Leicht bewoelkt;11;10;0
29.10.2018 18:00;518;247;271;Leicht bewoelkt;11;10;0
29.10.2018 19:00;354;142;212;Leicht bewoelkt;11;10;0
29.10.2018 20:00;233;106;127;Leicht bewoelkt;11;10;0
29.10.2018 21:00;168;60;108;Leicht bewoelkt;10;10;0
29.10.2018 22:00;114;53;61;Leicht bewoelkt;10;9;0
29.10.2018 23:00;82;33;49;Stellenweiser Regenfall;10;9;0
30.10.2018 00:00;39;21;18;Stellenweiser Regenfall;10;8;0
30.10.2018 01:00;17;9;8;Stellenweiser Regenfall;9;7;0
30.10.2018 02:00;4;3;1;Leicht bewoelkt;8;5;0
30.10.2018 03:00;1;1;0;Leicht bewoelkt;8;4;0
30.10.2018 04:00;3;2;1;Leicht bewoelkt;7;3;0
30.10.2018 05:00;32;18;14;Leicht bewoelkt;6;2;0
30.10.2018 06:00;115;78;37;Leicht bewoelkt;5;1;0
30.10.2018 07:00;472;306;166;Leicht bewoelkt;5;1;0
30.10.2018 08:00;550;314;236;Bewoelkt;5;1;0
30.10.2018 09:00;564;370;194;Bewoelkt;5;2;0
30.10.2018 10:00;339;176;163;Bewoelkt;5;3;0
30.10.2018 11:00;463;240;223;Stellenweiser Nieselregen;6;3;0
30.10.2018 12:00;388;167;221;Stellenweiser Nieselregen;6;4;0
30.10.2018 13:00;350;161;189;Stellenweiser Nieselregen;6;4;0
30.10.2018 14:00;325;170;155;Stellenweiser Nieselregen;7;4;0
30.10.2018 15:00;470;226;244;Stellenweiser Nieselregen;7;5;0
30.10.2018 16:00;524;268;256;Stellenweiser Nieselregen;7;5;0
30.10.2018 17:00;614;273;341;Stellenweiser Nieselregen;6;4;0
30.10.2018 18:00;495;208;287;Stellenweiser Nieselregen;6;4;0
30.10.2018 19:00;465;196;269;Stellenweiser Nieselregen;5;4;0
30.10.2018 20:00;230;116;114;Leicht bewoelkt;5;4;0
30.10.2018 21:00;197;84;113;Leicht bewoelkt;4;3;0
30.10.2018 22:00;199;76;123;Leicht bewoelkt;4;3;0
30.10.2018 23:00;117;52;65;Leicht bewoelkt;4;3;0
31.10.2018 00:00;67;20;47;Leicht bewoelkt;4;3;0
31.10.2018 01:00;23;10;13;Leicht bewoelkt;4;3;0
31.10.2018 02:00;8;4;4;Leicht bewoelkt;4;3;0
31.10.2018 03:00;10;8;2;Leicht bewoelkt;4;2;0
31.10.2018 04:00;7;2;5;Leicht bewoelkt;4;2;0
31.10.2018 05:00;26;17;9;Leicht bewoelkt;4;2;0
31.10.2018 06:00;130;81;49;Leicht bewoelkt;4;2;0
31.10.2018 07:00;556;389;167;Leicht bewoelkt;5;3;0
31.10.2018 08:00;481;282;199;Leicht bewoelkt;6;5;0
31.10.2018 09:00;560;338;222;Leicht bewoelkt;8;7;0
31.10.2018 10:00;355;188;167;Leicht bewoelkt;9;8;0
31.10.2018 11:00;497;218;279;Bewoelkt;11;10;0
31.10.2018 12:00;489;220;269;Bewoelkt;13;12;0
31.10.2018 13:00;536;288;248;Bewoelkt;13;12;0
31.10.2018 14:00;436;190;246;Leicht bewoelkt;13;12;0
31.10.2018 15:00;604;297;307;Leicht bewoelkt;13;12;0
31.10.2018 16:00;594;264;330;Leicht bewoelkt;12;11;0
31.10.2018 17:00;768;347;421;Leicht bewoelkt;11;10;0
31.10.2018 18:00;553;254;299;Leicht bewoelkt;10;9;0
31.10.2018 19:00;444;211;233;Leicht bewoelkt;10;9;0
31.10.2018 20:00;374;158;216;Leicht bewoelkt;9;8;0
31.10.2018 21:00;269;140;129;Leicht bewoelkt;8;7;0
31.10.2018 22:00;231;111;120;Leicht bewoelkt;8;7;0
31.10.2018 23:00;185;93;92;Leicht bewoelkt;8;7;0
01.11.2018 00:00;158;72;86;Leicht bewoelkt;8;7;0
01.11.2018 01:00;134;41;93;Leicht bewoelkt;8;7;0
01.11.2018 02:00;106;51;55;Leicht bewoelkt;8;7;0
01.11.2018 03:00;81;31;50;Leicht bewoelkt;8;7;0
01.11.2018 04:00;32;20;12;Leicht bewoelkt;8;7;0
01.11.2018 05:00;28;18;10;Leicht bewoelkt;7;7;0
01.11.2018 06:00;39;28;11;Leicht bewoelkt;7;7;0
01.11.2018 07:00;40;32;8;Leicht bewoelkt;8;7;0
01.11.2018 08:00;72;44;28;Stellenweiser Regenfall;8;8;0
01.11.2018 09:00;107;59;48;Stellenweiser Regenfall;9;8;0
01.11.2018 10:00;140;75;65;Stellenweiser Regenfall;10;9;0
01.11.2018 11:00;188;102;86;Stellenweiser Nieselregen;11;10;0
01.11.2018 12:00;196;107;89;Stellenweiser Nieselregen;12;11;0
01.11.2018 13:00;263;160;103;Stellenweiser Nieselregen;12;11;0
01.11.2018 14:00;340;187;153;Stellenweiser Regenfall;12;12;0
01.11.2018 15:00;392;191;201;Stellenweiser Regenfall;13;13;0
01.11.2018 16:00;373;203;170;Stellenweiser Regenfall;12;12;0
01.11.2018 17:00;345;151;194;Leicht bewoelkt;11;11;0
01.11.2018 18:00;261;100;161;Leicht bewoelkt;10;10;0
01.11.2018 19:00;269;102;167;Leicht bewoelkt;9;9;0
01.11.2018 20:00;153;59;94;Leicht bewoelkt;8;8;0
01.11.2018 21:00;112;61;51;Leicht bewoelkt;7;7;0
01.11.2018 22:00;134;41;93;Leicht bewoelkt;7;7;0
01.11.2018 23:00;131;86;45;Leicht bewoelkt;7;7;0
02.11.2018 00:00;42;24;18;Leicht bewoelkt;6;6;0
02.11.2018 01:00;31;8;23;Leicht bewoelkt;6;6;0
02.11.2018 02:00;10;5;5;Leicht bewoelkt;6;6;0
02.11.2018 03:00;2;1;1;Leicht bewoelkt;7;6;0
02.11.2018 04:00;6;4;2;Leicht bewoelkt;7;6;0
02.11.2018 05:00;26;18;8;Bedeckt;7;6;0
02.11.2018 06:00;94;63;31;Bedeckt;7;7;0
02.11.2018 07:00;259;155;104;Bedeckt;8;8;0
02.11.2018 08:00;405;228;177;Leicht bewoelkt;9;9;0
02.11.2018 09:00;418;255;163;Leicht bewoelkt;10;10;0
02.11.2018 10:00;394;248;146;Leicht bewoelkt;11;11;0
02.11.2018 11:00;436;223;213;Leicht bewoelkt;11;11;0
02.11.2018 12:00;460;208;252;Leicht bewoelkt;12;12;0
02.11.2018 13:00;513;230;283;Leicht bewoelkt;12;12;0
02.11.2018 14:00;472;239;233;Leicht bewoelkt;12;12;0
02.11.2018 15:00;452;221;231;Leicht bewoelkt;13;12;0
02.11.2018 16:00;499;238;261;Leicht bewoelkt;12;11;0
02.11.2018 17:00;530;233;297;Bewoelkt;11;10;0
02.11.2018 18:00;445;206;239;Bewoelkt;10;9;0
02.11.2018 19:00;333;152;181;Bewoelkt;10;8;0
02.11.2018 20:00;231;88;143;Bedeckt;9;7;0
02.11.2018 21:00;168;75;93;Bedeckt;8;7;0
02.11.2018 22:00;174;70;104;Bedeckt;8;6;0
02.11.2018 23:00;156;57;99;Bedeckt;7;5;0
03.11.2018 00:00;106;43;63;Bedeckt;7;5;0
03.11.2018 01:00;77;33;44;Bedeckt;7;5;0
03.11.2018 02:00;57;20;37;Bewoelkt;7;5;0
03.11.2018 03:00;22;10;12;Bewoelkt;7;5;0
03.11.2018 04:00;19;13;6;Bewoelkt;7;5;0
03.11.2018 05:00;24;15;9;Leicht bewoelkt;7;5;0
03.11.2018 06:00;42;27;15;Leicht bewoelkt;8;5;0
03.11.2018 07:00;48;26;22;Leicht bewoelkt;8;5;0
03.11.2018 08:00;136;95;41;Bewoelkt;8;6;0
03.11.2018 09:00;247;165;82;Bewoelkt;9;7;0
03.11.2018 10:00;285;158;127;Bewoelkt;10;8;0
03.11.2018 11:00;409;244;165;Leicht bewoelkt;10;9;0
03.11.2018 12:00;455;219;236;Leicht bewoelkt;11;10;0
03.11.2018 13:00;391;188;203;Leicht bewoelkt;11;10;0
03.11.2018 14:00;473;244;229;Leicht bewoelkt;11;10;0
03.11.2018 15:00;423;207;216;Leicht bewoelkt;11;10;0
03.11.2018 16:00;408;164;244;Leicht bewoelkt;11;9;0
03.11.2018 17:00;350;156;194;Leicht bewoelkt;10;9;0
03.11.2018 18:00;321;152;169;Leicht bewoelkt;9;8;0
03.11.2018 19:00;236;135;101;Leicht bewoelkt;9;7;0
03.11.2018 20:00;212;93;119;Leichter Nebel;8;7;0
03.11.2018 21:00;153;81;72;Leichter Nebel;7;6;0
03.11.2018 22:00;127;46;81;Leichter Nebel;7;6;0
03.11.2018 23:00;147;53;94;Leichter Nebel;7;7;0
04.11.2018 00:00;139;58;81;Leichter Nebel;7;7;0
04.11.2018 01:00;95;37;58;Leichter Nebel;7;7;0
04.11.2018 02:00;67;16;51;Leicht bewoelkt;7;7;0
04.11.2018 03:00;48;18;30;Leicht bewoelkt;7;7;0
04.11.2018 04:00;13;8;5;Leicht bewoelkt;7;7;0
04.11.2018 05:00;19;9;10;Leichter Nebel;7;7;0
04.11.2018 06:00;19;10;9;Leichter Nebel;7;7;0
04.11.2018 07:00;28;15;13;Leichter Nebel;8;7;0
04.11.2018 08:00;50;20;30;Leicht bewoelkt;9;8;0
04.11.2018 09:00;151;77;74;Leicht bewoelkt;9;9;0
04.11.2018 10:00;133;61;72;Leicht bewoelkt;11;10;0
04.11.2018 11:00;196;93;103;Leicht bewoelkt;12;11;0
04.11.2018 12:00;186;100;86;Leicht bewoelkt;13;12;0
04.11.2018 13:00;218;108;110;Leicht bewoelkt;13;13;0
04.11.2018 14:00;265;146;119;Leicht bewoelkt;14;13;0
04.11.2018 15:00;238;112;126;Leicht bewoelkt;14;13;0
04.11.2018 16:00;283;133;150;Leicht bewoelkt;13;12;0
04.11.2018 17:00;302;136;166;Leicht bewoelkt;12;11;0
04.11.2018 18:00;258;128;130;Leicht bewoelkt;11;11;0
04.11.2018 19:00;173;103;70;Leicht bewoelkt;10;10;0
04.11.2018 20:00;173;81;92;Leicht bewoelkt;9;9;0
04.11.2018 21:00;101;40;61;Leicht bewoelkt;8;8;0
04.11.2018 22:00;90;44;46;Leicht bewoelkt;8;8;0
04.11.2018 23:00;64;27;37;Leicht bewoelkt;8;8;0
05.11.2018 00:00;25;8;17;Leicht bewoelkt;9;9;0
05.11.2018 01:00;9;3;6;Leicht bewoelkt;9;9;0
05.11.2018 02:00;8;6;2;Leicht bewoelkt;9;8;0
05.11.2018 03:00;0;0;0;Leicht bewoelkt;8;8;0
05.11.2018 04:00;6;5;1;Leicht bewoelkt;8;8;0
05.11.2018 05:00;38;24;14;Leicht bewoelkt;8;8;0
05.11.2018 06:00;147;90;57;Leicht bewoelkt;7;7;0
05.11.2018 07:00;993;628;365;Leicht bewoelkt;9;9;0
05.11.2018 08:00;623;349;274;Leicht bewoelkt;10;10;0
05.11.2018 09:00;656;420;236;Leicht bewoelkt;11;11;0
05.11.2018 10:00;347;200;147;Leicht bewoelkt;13;13;0
05.11.2018 11:00;504;229;275;Leicht bewoelkt;14;14;0
05.11.2018 12:00;528;222;306;Leicht bewoelkt;16;16;0
05.11.2018 13:00;850;335;515;Leicht bewoelkt;16;16;0
05.11.2018 14:00;532;267;265;Leicht bewoelkt;16;16;0
05.11.2018 15:00;935;424;511;Leicht bewoelkt;16;16;0
05.11.2018 16:00;775;367;408;Leicht bewoelkt;15;15;0
05.11.2018 17:00;923;410;513;Leicht bewoelkt;14;14;0
05.11.2018 18:00;765;367;398;Leicht bewoelkt;13;13;0
05.11.2018 19:00;626;273;353;Leicht bewoelkt;12;12;0
05.11.2018 20:00;396;194;202;Leicht bewoelkt;12;12;0
05.11.2018 21:00;222;93;129;Leicht bewoelkt;11;11;0
05.11.2018 22:00;184;70;114;Leicht bewoelkt;11;10;0
05.11.2018 23:00;109;41;68;Leicht bewoelkt;10;10;0
06.11.2018 00:00;63;34;29;Leicht bewoelkt;10;10;0
06.11.2018 01:00;28;10;18;Leicht bewoelkt;10;10;0
06.11.2018 02:00;9;7;2;Leicht bewoelkt;10;10;0
06.11.2018 03:00;5;0;5;Leicht bewoelkt;10;10;0
06.11.2018 04:00;9;6;3;Leicht bewoelkt;10;9;0
06.11.2018 05:00;41;27;14;Leicht bewoelkt;9;9;0
06.11.2018 06:00;158;101;57;Leicht bewoelkt;9;9;0
06.11.2018 07:00;1052;696;356;Leicht bewoelkt;11;10;0
06.11.2018 08:00;710;391;319;Leicht bewoelkt;12;12;0
06.11.2018 09:00;666;395;271;Leicht bewoelkt;13;13;0
06.11.2018 10:00;354;187;167;Leicht bewoelkt;14;15;0
06.11.2018 11:00;570;254;316;Leicht bewoelkt;16;16;0
06.11.2018 12:00;531;224;307;Leicht bewoelkt;17;18;0
06.11.2018 13:00;777;325;452;Leicht bewoelkt;17;18;0
06.11.2018 14:00;465;190;275;Leicht bewoelkt;17;17;0
06.11.2018 15:00;894;392;502;Leicht bewoelkt;17;17;0
06.11.2018 16:00;697;316;381;Leicht bewoelkt;16;16;0
06.11.2018 17:00;932;421;511;Leicht bewoelkt;15;14;0
06.11.2018 18:00;675;311;364;Leicht bewoelkt;13;12;0
06.11.2018 19:00;620;276;344;Leicht bewoelkt;12;11;0
06.11.2018 20:00;415;210;205;Leicht bewoelkt;11;10;0
06.11.2018 21:00;248;103;145;Leicht bewoelkt;10;10;0
06.11.2018 22:00;224;76;148;Leicht bewoelkt;10;9;0
06.11.2018 23:00;155;62;93;Leicht bewoelkt;10;9;0
07.11.2018 00:00;45;13;32;Leicht bewoelkt;9;9;0
07.11.2018 01:00;34;13;21;Leicht bewoelkt;9;8;0
07.11.2018 02:00;12;3;9;Bewoelkt;9;8;0
07.11.2018 03:00;3;2;1;Bewoelkt;8;7;0
07.11.2018 04:00;4;4;0;Bewoelkt;8;7;0
07.11.2018 05:00;34;21;13;Leicht bewoelkt;8;7;0
07.11.2018 06:00;153;91;62;Leicht bewoelkt;8;7;0
07.11.2018 07:00;1022;652;370;Leicht bewoelkt;9;8;0
07.11.2018 08:00;730;421;309;Leicht bewoelkt;10;10;0
07.11.2018 09:00;728;441;287;Leicht bewoelkt;11;11;0
07.11.2018 10:00;352;199;153;Leicht bewoelkt;12;12;0
07.11.2018 11:00;601;259;342;Leicht bewoelkt;14;14;0
07.11.2018 12:00;642;304;338;Leicht bewoelkt;15;15;0
07.11.2018 13:00;999;461;538;Leicht bewoelkt;15;15;0
07.11.2018 14:00;621;305;316;Leicht bewoelkt;15;15;0
07.11.2018 15:00;817;373;444;Leicht bewoelkt;15;15;0
07.11.2018 16:00;827;388;439;Leicht bewoelkt;14;14;0
07.11.2018 17:00;967;399;568;Leicht bewoelkt;12;12;0
07.11.2018 18:00;747;341;406;Leicht bewoelkt;11;11;0
07.11.2018 19:00;625;281;344;Leicht bewoelkt;11;10;0
07.11.2018 20:00;495;251;244;Leicht bewoelkt;10;10;0
07.11.2018 21:00;261;139;122;Leicht bewoelkt;9;9;0
07.11.2018 22:00;235;78;157;Leicht bewoelkt;9;9;0
07.11.2018 23:00;196;85;111;Bewoelkt;9;9;0
08.11.2018 00:00;78;16;62;Bewoelkt;9;9;0
08.11.2018 01:00;49;10;39;Bewoelkt;9;9;0
08.11.2018 02:00;25;11;14;Stellenweiser Nieselregen;9;9;0
08.11.2018 03:00;2;1;1;Stellenweiser Nieselregen;9;8;0
08.11.2018 04:00;5;3;2;Stellenweiser Nieselregen;9;8;0
08.11.2018 05:00;33;22;11;Leichter Regenfall;9;8;0
08.11.2018 06:00;128;72;56;Leichter Regenfall;9;8;0
08.11.2018 07:00;969;595;374;Leichter Regenfall;9;9;0
08.11.2018 08:00;712;391;321;Nieselregen;9;9;0
08.11.2018 09:00;722;445;277;Nieselregen;10;10;0
08.11.2018 10:00;387;211;176;Nieselregen;10;10;0
08.11.2018 11:00;598;295;303;Stellenweiser Regenfall;11;11;0
08.11.2018 12:00;569;244;325;Stellenweiser Regenfall;11;11;0
08.11.2018 13:00;899;393;506;Stellenweiser Regenfall;12;11;0
08.11.2018 14:00;549;242;307;Bewoelkt;12;11;0
08.11.2018 15:00;929;443;486;Bewoelkt;12;11;0
08.11.2018 16:00;803;344;459;Bewoelkt;11;10;0
08.11.2018 17:00;948;439;509;Leicht bewoelkt;10;9;0
08.11.2018 18:00;740;349;391;Leicht bewoelkt;9;8;0
08.11.2018 19:00;534;254;280;Leicht bewoelkt;9;7;0
08.11.2018 20:00;368;170;198;Leicht bewoelkt;8;7;0
08.11.2018 21:00;279;130;149;Leicht bewoelkt;8;7;0
08.11.2018 22:00;231;94;137;Leicht bewoelkt;7;7;0
08.11.2018 23:00;158;64;94;Bedeckt;7;7;0
09.11.2018 00:00;104;36;68;Bedeckt;7;7;0
09.11.2018 01:00;58;28;30;Bedeckt;7;7;0
09.11.2018 02:00;28;16;12;Leicht bewoelkt;7;7;0
09.11.2018 03:00;15;10;5;Leicht bewoelkt;7;7;0
09.11.2018 04:00;10;7;3;Leicht bewoelkt;7;7;0
09.11.2018 05:00;42;26;16;Leicht bewoelkt;7;7;0
09.11.2018 06:00;150;92;58;Leicht bewoelkt;7;7;0
09.11.2018 07:00;904;587;317;Leicht bewoelkt;8;8;0
09.11.2018 08:00;696;415;281;Leicht bewoelkt;9;9;0
09.11.2018 09:00;610;355;255;Leicht bewoelkt;10;10;0
09.11.2018 10:00;432;222;210;Leicht bewoelkt;11;11;0
09.11.2018 11:00;599;292;307;Leicht bewoelkt;12;12;0
09.11.2018 12:00;671;295;376;Leicht bewoelkt;13;13;0
09.11.2018 13:00;971;358;613;Leicht bewoelkt;13;13;0
09.11.2018 14:00;631;298;333;Leicht bewoelkt;13;13;0
09.11.2018 15:00;723;339;384;Leicht bewoelkt;13;13;0
09.11.2018 16:00;676;315;361;Leicht bewoelkt;12;12;0
09.11.2018 17:00;776;349;427;Leicht bewoelkt;11;11;0
09.11.2018 18:00;592;259;333;Leicht bewoelkt;11;10;0
09.11.2018 19:00;501;274;227;Leicht bewoelkt;10;10;0
09.11.2018 20:00;370;209;161;Leicht bewoelkt;9;9;0
09.11.2018 21:00;215;112;103;Leicht bewoelkt;9;9;0
09.11.2018 22:00;227;87;140;Leicht bewoelkt;9;9;0
09.11.2018 23:00;189;58;131;Leicht bewoelkt;8;8;0
10.11.2018 00:00;167;55;112;Leicht bewoelkt;8;8;0
10.11.2018 01:00;105;22;83;Leicht bewoelkt;8;8;0
10.11.2018 02:00;51;18;33;Leicht bewoelkt;8;8;0
10.11.2018 03:00;45;16;29;Leicht bewoelkt;7;8;0
10.11.2018 04:00;24;13;11;Leicht bewoelkt;7;7;0
10.11.2018 05:00;29;20;9;Leicht bewoelkt;7;7;0
10.11.2018 06:00;37;25;12;Leicht bewoelkt;7;7;0
10.11.2018 07:00;83;48;35;Leicht bewoelkt;8;8;0
10.11.2018 08:00;191;119;72;Leicht bewoelkt;9;9;0
10.11.2018 09:00;312;204;108;Leicht bewoelkt;11;11;0
10.11.2018 10:00;415;242;173;Leicht bewoelkt;12;12;0
10.11.2018 11:00;459;245;214;Leicht bewoelkt;14;14;0
10.11.2018 12:00;466;236;230;Leicht bewoelkt;15;15;0
10.11.2018 13:00;514;270;244;Leicht bewoelkt;15;15;0
10.11.2018 14:00;511;249;262;Leicht bewoelkt;15;15;0
10.11.2018 15:00;539;261;278;Leicht bewoelkt;15;15;0
10.11.2018 16:00;541;231;310;Leicht bewoelkt;14;14;0
10.11.2018 17:00;525;229;296;Leicht bewoelkt;13;13;0
10.11.2018 18:00;388;154;234;Leicht bewoelkt;12;12;0
10.11.2018 19:00;282;126;156;Leicht bewoelkt;11;11;0
10.11.2018 20:00;300;141;159;Leicht bewoelkt;11;11;0
10.11.2018 21:00;267;141;126;Leicht bewoelkt;10;10;0
10.11.2018 22:00;168;62;106;Leicht bewoelkt;10;10;0
10.11.2018 23:00;158;66;92;Leicht bewoelkt;9;9;0
11.11.2018 00:00;169;67;102;Leicht bewoelkt;9;9;0
11.11.2018 01:00;134;48;86;Leicht bewoelkt;9;9;0
11.11.2018 02:00;79;30;49;Leicht bewoelkt;8;8;0
11.11.2018 03:00;65;21;44;Leicht bewoelkt;8;8;0
11.11.2018 04:00;30;10;20;Leicht bewoelkt;8;8;0
11.11.2018 05:00;27;17;10;Stellenweiser Nieselregen;8;8;0
11.11.2018 06:00;19;13;6;Stellenweiser Nieselregen;8;8;0
11.11.2018 07:00;28;18;10;Stellenweiser Nieselregen;9;9;0
11.11.2018 08:00;48;18;30;Stellenweiser Regenfall;10;10;0
11.11.2018 09:00;110;67;43;Stellenweiser Regenfall;11;11;0
11.11.2018 10:00;107;56;51;Stellenweiser Regenfall;12;12;0
11.11.2018 11:00;179;102;77;Leicht bewoelkt;14;14;0
11.11.2018 12:00;237;110;127;Leicht bewoelkt;15;15;0
11.11.2018 13:00;305;138;167;Leicht bewoelkt;15;15;0
11.11.2018 14:00;377;190;187;Leicht bewoelkt;15;15;0
11.11.2018 15:00;360;205;155;Leicht bewoelkt;15;15;0
11.11.2018 16:00;426;223;203;Leicht bewoelkt;14;14;0
11.11.2018 17:00;294;133;161;Leicht bewoelkt;13;13;0
11.11.2018 18:00;237;116;121;Leicht bewoelkt;12;12;0
11.11.2018 19:00;185;90;95;Leicht bewoelkt;12;12;0
11.11.2018 20:00;167;83;84;Leicht bewoelkt;11;11;0
11.11.2018 21:00;110;51;59;Leicht bewoelkt;11;11;0
11.11.2018 22:00;101;44;57;Leicht bewoelkt;10;10;0
11.11.2018 23:00;76;35;41;Leicht bewoelkt;10;9;0
12.11.2018 00:00;32;16;16;Leicht bewoelkt;9;9;0
12.11.2018 01:00;10;2;8;Leicht bewoelkt;9;9;0
12.11.2018 02:00;5;4;1;Leicht bewoelkt;9;9;0
12.11.2018 03:00;2;2;0;Leicht bewoelkt;9;9;0
12.11.2018 04:00;8;4;4;Leicht bewoelkt;9;9;0
12.11.2018 05:00;36;25;11;Leicht bewoelkt;9;9;0
12.11.2018 06:00;140;80;60;Leicht bewoelkt;9;9;0
12.11.2018 07:00;967;639;328;Leicht bewoelkt;10;10;0
12.11.2018 08:00;707;392;315;Leicht bewoelkt;11;11;0
12.11.2018 09:00;673;445;228;Leicht bewoelkt;12;12;0
12.11.2018 10:00;310;178;132;Leicht bewoelkt;14;14;0
12.11.2018 11:00;530;244;286;Leicht bewoelkt;15;15;0
12.11.2018 12:00;582;250;332;Leicht bewoelkt;16;16;0
12.11.2018 13:00;838;354;484;Leicht bewoelkt;16;16;0
12.11.2018 14:00;565;295;270;Leicht bewoelkt;16;16;0
12.11.2018 15:00;916;423;493;Leicht bewoelkt;16;16;0
12.11.2018 16:00;830;355;475;Leicht bewoelkt;15;15;0
12.11.2018 17:00;923;426;497;Leicht bewoelkt;14;14;0
12.11.2018 18:00;748;354;394;Leicht bewoelkt;13;13;0
12.11.2018 19:00;614;274;340;Leicht bewoelkt;12;12;0
12.11.2018 20:00;407;209;198;Leicht bewoelkt;12;12;0
12.11.2018 21:00;266;107;159;Leicht bewoelkt;11;11;0
12.11.2018 22:00;197;60;137;Leicht bewoelkt;11;11;0
12.11.2018 23:00;106;44;62;Leicht bewoelkt;10;10;0
13.11.2018 00:00;58;23;35;Leicht bewoelkt;10;10;0
13.11.2018 01:00;30;15;15;Leicht bewoelkt;10;10;0
13.11.2018 02:00;6;4;2;Leicht bewoelkt;10;10;0
13.11.2018 03:00;9;4;5;Leicht bewoelkt;9;10;0
13.11.2018 04:00;8;4;4;Leicht bewoelkt;9;9;0
13.11.2018 05:00;31;22;9;Leicht bewoelkt;9;9;0
13.11.2018 06:00;165;99;66;Leicht bewoelkt;9;9;0
13.11.2018 07:00;1045;703;342;Leicht bewoelkt;10;10;0
13.11.2018 08:00;781;444;337;Leicht bewoelkt;11;10;0
13.11.2018 09:00;690;392;298;Leicht bewoelkt;12;11;0
13.11.2018 10:00;352;197;155;Leicht bewoelkt;12;12;0
13.11.2018 11:00;558;274;284;Leicht bewoelkt;13;12;0
13.11.2018 12:00;478;197;281;Leicht bewoelkt;14;13;0
13.11.2018 13:00;792;318;474;Leicht bewoelkt;13;13;0
13.11.2018 14:00;384;188;196;Leicht bewoelkt;13;13;0
13.11.2018 15:00;808;338;470;Leicht bewoelkt;13;13;0
13.11.2018 16:00;706;341;365;Leicht bewoelkt;12;12;0
13.11.2018 17:00;825;336;489;Leicht bewoelkt;12;12;0
13.11.2018 18:00;693;297;396;Leicht bewoelkt;11;11;0
13.11.2018 19:00;697;324;373;Leicht bewoelkt;10;10;0
13.11.2018 20:00;286;142;144;Bedeckt;10;10;0
13.11.2018 21:00;230;110;120;Bedeckt;10;10;0
13.11.2018 22:00;225;77;148;Bedeckt;9;9;0
13.11.2018 23:00;125;55;70;Leicht bewoelkt;9;8;0
14.11.2018 00:00;46;18;28;Leicht bewoelkt;8;8;0
14.11.2018 01:00;24;13;11;Leicht bewoelkt;7;7;0
14.11.2018 02:00;19;5;14;Leicht bewoelkt;7;6;0
14.11.2018 03:00;2;1;1;Leicht bewoelkt;6;5;0
14.11.2018 04:00;5;5;0;Leicht bewoelkt;6;5;0
14.11.2018 05:00;47;29;18;Leicht bewoelkt;5;4;0
14.11.2018 06:00;129;77;52;Leicht bewoelkt;5;4;0
14.11.2018 07:00;1037;677;360;Leicht bewoelkt;6;5;0
14.11.2018 08:00;724;417;307;Leicht bewoelkt;7;6;0
14.11.2018 09:00;666;409;257;Leicht bewoelkt;8;7;0
14.11.2018 10:00;360;179;181;Leicht bewoelkt;9;8;0
14.11.2018 11:00;569;260;309;Leicht bewoelkt;11;10;0
14.11.2018 12:00;577;265;312;Leicht bewoelkt;12;12;0
14.11.2018 13:00;875;421;454;Leicht bewoelkt;12;12;0
14.11.2018 14:00;526;262;264;Leicht bewoelkt;13;12;0
14.11.2018 15:00;798;365;433;Leicht bewoelkt;13;13;0
14.11.2018 16:00;755;359;396;Leicht bewoelkt;12;12;0
14.11.2018 17:00;959;369;590;Sonnig;11;11;0
14.11.2018 18:00;711;348;363;Sonnig;10;10;0
14.11.2018 19:00;556;242;314;Sonnig;9;9;0
14.11.2018 20:00;431;225;206;Leicht bewoelkt;8;8;0
14.11.2018 21:00;302;116;186;Leicht bewoelkt;8;8;0
14.11.2018 22:00;247;63;184;Leicht bewoelkt;8;8;0
14.11.2018 23:00;161;44;117;Leicht bewoelkt;8;8;0
15.11.2018 00:00;84;21;63;Leicht bewoelkt;8;8;0
15.11.2018 01:00;30;3;27;Leicht bewoelkt;7;7;0
15.11.2018 02:00;12;5;7;Sonnig;7;6;0
15.11.2018 03:00;17;10;7;Sonnig;6;6;0
15.11.2018 04:00;8;7;1;Sonnig;6;5;0
15.11.2018 05:00;30;18;12;Sonnig;5;5;0
15.11.2018 06:00;129;73;56;Sonnig;5;4;0
15.11.2018 07:00;971;612;359;Sonnig;5;5;0
15.11.2018 08:00;696;393;303;Leicht bewoelkt;6;5;0
15.11.2018 09:00;655;423;232;Leicht bewoelkt;7;6;0
15.11.2018 10:00;287;156;131;Leicht bewoelkt;8;7;0
15.11.2018 11:00;567;252;315;Leicht bewoelkt;9;8;0
15.11.2018 12:00;516;226;290;Leicht bewoelkt;10;9;0
15.11.2018 13:00;853;385;468;Leicht bewoelkt;10;9;0
15.11.2018 14:00;483;230;253;Leicht bewoelkt;10;9;0
15.11.2018 15:00;850;361;489;Leicht bewoelkt;10;9;0
15.11.2018 16:00;732;334;398;Leicht bewoelkt;9;8;0
15.11.2018 17:00;882;346;536;Leicht bewoelkt;8;7;0
15.11.2018 18:00;759;361;398;Leicht bewoelkt;7;6;0
15.11.2018 19:00;567;279;288;Leicht bewoelkt;6;5;0
15.11.2018 20:00;389;177;212;Leicht bewoelkt;5;4;0
15.11.2018 21:00;293;135;158;Leicht bewoelkt;4;4;0
15.11.2018 22:00;285;121;164;Leicht bewoelkt;4;3;0
15.11.2018 23:00;193;75;118;Leicht bewoelkt;4;3;0
16.11.2018 00:00;95;35;60;Leicht bewoelkt;4;3;0
16.11.2018 01:00;56;14;42;Leicht bewoelkt;3;2;0
16.11.2018 02:00;74;10;64;Leicht bewoelkt;3;1;0
16.11.2018 03:00;31;18;13;Leicht bewoelkt;2;0;0
16.11.2018 04:00;12;6;6;Leicht bewoelkt;2;0;0
16.11.2018 05:00;35;17;18;Leicht bewoelkt;1;-1;0
16.11.2018 06:00;145;81;64;Leicht bewoelkt;1;-1;0
16.11.2018 07:00;833;559;274;Leicht bewoelkt;2;-1;0
16.11.2018 08:00;611;331;280;Leicht bewoelkt;3;0;0
16.11.2018 09:00;576;373;203;Leicht bewoelkt;3;1;0
16.11.2018 10:00;384;225;159;Leicht bewoelkt;5;2;0
16.11.2018 11:00;535;270;265;Leicht bewoelkt;6;4;0
16.11.2018 12:00;595;271;324;Leicht bewoelkt;7;5;0
16.11.2018 13:00;832;346;486;Leicht bewoelkt;7;5;0
16.11.2018 14:00;577;282;295;Leicht bewoelkt;8;6;0
16.11.2018 15:00;619;279;340;Leicht bewoelkt;8;6;0
16.11.2018 16:00;633;281;352;Leicht bewoelkt;7;4;0
16.11.2018 17:00;653;281;372;Sonnig;6;3;0
16.11.2018 18:00;557;246;311;Sonnig;5;2;0
16.11.2018 19:00;441;223;218;Sonnig;4;1;0
16.11.2018 20:00;318;156;162;Leicht bewoelkt;3;0;0
16.11.2018 21:00;230;125;105;Leicht bewoelkt;3;0;0
16.11.2018 22:00;232;111;121;Leicht bewoelkt;2;-1;0
16.11.2018 23:00;156;49;107;Leicht bewoelkt;2;-1;0
17.11.2018 00:00;142;46;96;Leicht bewoelkt;2;-1;0
17.11.2018 01:00;94;24;70;Leicht bewoelkt;2;-1;0
17.11.2018 02:00;52;26;26;Leicht bewoelkt;2;-2;0
17.11.2018 03:00;50;27;23;Leicht bewoelkt;2;-2;0
17.11.2018 04:00;17;6;11;Leicht bewoelkt;2;-2;0
17.11.2018 05:00;21;12;9;Leicht bewoelkt;1;-2;0
17.11.2018 06:00;28;14;14;Leicht bewoelkt;1;-2;0
17.11.2018 07:00;54;32;22;Leicht bewoelkt;2;-1;0
17.11.2018 08:00;152;102;50;Leicht bewoelkt;3;-1;0
17.11.2018 09:00;251;170;81;Leicht bewoelkt;3;0;0
17.11.2018 10:00;355;210;145;Leicht bewoelkt;4;1;0
17.11.2018 11:00;358;206;152;Sonnig;6;3;0
17.11.2018 12:00;418;210;208;Sonnig;7;4;0
17.11.2018 13:00;403;195;208;Sonnig;7;4;0
17.11.2018 14:00;456;219;237;Sonnig;7;4;0
17.11.2018 15:00;441;201;240;Sonnig;7;4;0
17.11.2018 16:00;465;236;229;Sonnig;7;3;0
17.11.2018 17:00;431;200;231;Sonnig;6;2;0
17.11.2018 18:00;382;157;225;Sonnig;5;1;0
17.11.2018 19:00;327;176;151;Sonnig;4;1;0
17.11.2018 20:00;221;135;86;Sonnig;4;0;0
17.11.2018 21:00;168;55;113;Sonnig;3;-1;0
17.11.2018 22:00;247;114;133;Sonnig;2;-1;0
17.11.2018 23:00;130;44;86;Sonnig;2;-2;0
18.11.2018 00:00;133;43;90;Sonnig;1;-2;0
18.11.2018 01:00;127;59;68;Sonnig;1;-3;0
18.11.2018 02:00;42;17;25;Leicht bewoelkt;0;-3;0
18.11.2018 03:00;47;20;27;Leicht bewoelkt;0;-4;0
18.11.2018 04:00;17;8;9;Leicht bewoelkt;0;-4;0
18.11.2018 05:00;16;10;6;Leicht bewoelkt;0;-4;0
18.11.2018 06:00;22;9;13;Leicht bewoelkt;-1;-4;0
18.11.2018 07:00;28;14;14;Leicht bewoelkt;0;-4;0
18.11.2018 08:00;53;26;27;Leicht bewoelkt;1;-3;0
18.11.2018 09:00;141;81;60;Leicht bewoelkt;1;-2;0
18.11.2018 10:00;155;105;50;Leicht bewoelkt;2;-1;0
18.11.2018 11:00;194;95;99;Sonnig;3;0;0
18.11.2018 12:00;164;91;73;Sonnig;4;1;0
18.11.2018 13:00;221;111;110;Sonnig;4;1;0
18.11.2018 14:00;286;139;147;Sonnig;5;2;0
18.11.2018 15:00;309;163;146;Sonnig;5;2;0
18.11.2018 16:00;351;168;183;Sonnig;4;1;0
18.11.2018 17:00;296;148;148;Leicht bewoelkt;4;0;0
18.11.2018 18:00;228;102;126;Leicht bewoelkt;3;0;0
18.11.2018 19:00;185;100;85;Leicht bewoelkt;2;-1;0
18.11.2018 20:00;149;73;76;Bedeckt;1;-1;0
18.11.2018 21:00;107;45;62;Bedeckt;0;-1;0
18.11.2018 22:00;100;29;71;Bedeckt;0;-2;0
18.11.2018 23:00;55;12;43;Leichter Schneefall;1;-2;0
19.11.2018 00:00;30;8;22;Leichter Schneefall;1;-2;0
19.11.2018 01:00;14;7;7;Leichter Schneefall;1;-2;0
19.11.2018 02:00;7;3;4;Maessiger Schneefall;1;-3;0
19.11.2018 03:00;1;1;0;Maessiger Schneefall;1;-3;0
19.11.2018 04:00;8;6;2;Maessiger Schneefall;1;-3;0
19.11.2018 05:00;31;16;15;Bewoelkt;1;-3;0
19.11.2018 06:00;150;100;50;Bewoelkt;1;-4;0
19.11.2018 07:00;830;541;289;Bewoelkt;1;-4;0
19.11.2018 08:00;625;358;267;Bewoelkt;2;-4;0
19.11.2018 09:00;678;445;233;Bewoelkt;2;-4;0
19.11.2018 10:00;319;181;138;Bewoelkt;2;-3;0
19.11.2018 11:00;403;175;228;Leicht bewoelkt;2;-3;0
19.11.2018 12:00;503;229;274;Leicht bewoelkt;2;-3;0
19.11.2018 13:00;697;295;402;Leicht bewoelkt;2;-3;0
19.11.2018 14:00;422;199;223;Bedeckt;2;-2;0
19.11.2018 15:00;743;351;392;Bedeckt;2;-2;0
19.11.2018 16:00;610;274;336;Bedeckt;2;-3;0
19.11.2018 17:00;765;351;414;Leichter Schneefall;1;-3;0
19.11.2018 18:00;562;274;288;Leichter Schneefall;1;-4;0
19.11.2018 19:00;534;230;304;Leichter Schneefall;1;-4;0
19.11.2018 20:00;337;130;207;Bedeckt;1;-4;0
19.11.2018 21:00;215;93;122;Bedeckt;0;-4;0
19.11.2018 22:00;184;77;107;Bedeckt;0;-4;0
19.11.2018 23:00;103;47;56;Bedeckt;0;-4;0
20.11.2018 00:00;42;20;22;Bedeckt;0;-4;0
20.11.2018 01:00;8;4;4;Bedeckt;0;-4;0
20.11.2018 02:00;11;5;6;Leicht bewoelkt;-1;-4;0
20.11.2018 03:00;1;1;0;Leicht bewoelkt;-1;-5;0
20.11.2018 04:00;7;6;1;Leicht bewoelkt;-1;-5;0
20.11.2018 05:00;34;20;14;Leicht bewoelkt;-1;-4;0
20.11.2018 06:00;143;90;53;Leicht bewoelkt;-1;-4;0
20.11.2018 07:00;953;646;307;Leicht bewoelkt;0;-3;0
20.11.2018 08:00;637;379;258;Leicht bewoelkt;0;-2;0
20.11.2018 09:00;672;424;248;Leicht bewoelkt;1;-1;0
20.11.2018 10:00;337;170;167;Leicht bewoelkt;2;0;0
20.11.2018 11:00;501;254;247;Leicht bewoelkt;3;1;0
20.11.2018 12:00;476;190;286;Leicht bewoelkt;4;2;0
20.11.2018 13:00;713;280;433;Leicht bewoelkt;4;2;0
20.11.2018 14:00;443;202;241;Leicht bewoelkt;4;3;0
20.11.2018 15:00;732;346;386;Leicht bewoelkt;4;3;0
20.11.2018 16:00;641;292;349;Leicht bewoelkt;3;2;0
20.11.2018 17:00;864;408;456;Leicht bewoelkt;2;1;0
20.11.2018 18:00;661;290;371;Leicht bewoelkt;2;1;0
20.11.2018 19:00;570;240;330;Leicht bewoelkt;1;0;0
20.11.2018 20:00;355;186;169;Leicht bewoelkt;1;0;0
20.11.2018 21:00;246;90;156;Leicht bewoelkt;1;-1;0
20.11.2018 22:00;194;54;140;Leicht bewoelkt;1;0;0
20.11.2018 23:00;122;43;79;Leicht bewoelkt;2;0;0
21.11.2018 00:00;70;31;39;Leicht bewoelkt;2;1;0
21.11.2018 01:00;30;11;19;Leicht bewoelkt;2;0;0
21.11.2018 02:00;10;6;4;Leicht bewoelkt;2;0;0
21.11.2018 03:00;2;0;2;Leicht bewoelkt;1;0;0
21.11.2018 04:00;15;12;3;Leicht bewoelkt;1;-1;0
21.11.2018 05:00;43;24;19;Leicht bewoelkt;0;-1;0
21.11.2018 06:00;136;87;49;Leicht bewoelkt;0;-2;0
21.11.2018 07:00;973;640;333;Leicht bewoelkt;1;-1;0
21.11.2018 08:00;646;377;269;Bedeckt;2;0;0
21.11.2018 09:00;590;367;223;Bedeckt;3;1;0
21.11.2018 10:00;308;174;134;Bedeckt;4;2;0
21.11.2018 11:00;518;225;293;Leicht bewoelkt;5;3;0
21.11.2018 12:00;471;213;258;Leicht bewoelkt;6;5;0
21.11.2018 13:00;764;342;422;Leicht bewoelkt;6;4;0
21.11.2018 14:00;449;201;248;Leicht bewoelkt;5;4;0
21.11.2018 15:00;698;318;380;Leicht bewoelkt;5;4;0
21.11.2018 16:00;619;302;317;Leicht bewoelkt;4;3;0
21.11.2018 17:00;859;363;496;Leicht bewoelkt;3;3;0
21.11.2018 18:00;621;265;356;Leicht bewoelkt;3;2;0
21.11.2018 19:00;546;233;313;Leicht bewoelkt;2;2;0
21.11.2018 20:00;370;190;180;Bedeckt;2;2;0
21.11.2018 21:00;283;122;161;Bedeckt;2;2;0
21.11.2018 22:00;211;76;135;Bedeckt;2;2;0
21.11.2018 23:00;139;41;98;Bedeckt;2;2;0
22.11.2018 00:00;92;32;60;Bedeckt;2;2;0
22.11.2018 01:00;39;7;32;Bedeckt;2;2;0
22.11.2018 02:00;12;6;6;Leicht bewoelkt;2;1;0
22.11.2018 03:00;5;4;1;Leicht bewoelkt;2;1;0
22.11.2018 04:00;5;4;1;Leicht bewoelkt;1;1;0
22.11.2018 05:00;38;27;11;Stellenweiser Regenfall;1;1;0
22.11.2018 06:00;135;79;56;Stellenweiser Regenfall;1;0;0
22.11.2018 07:00;873;550;323;Stellenweiser Regenfall;2;2;0
22.11.2018 08:00;607;352;255;Leichter Eisregen;3;3;0
22.11.2018 09:00;658;422;236;Leichter Eisregen;4;4;0
22.11.2018 10:00;344;190;154;Leichter Eisregen;5;5;0
22.11.2018 11:00;468;203;265;Leicht bewoelkt;7;7;0
22.11.2018 12:00;484;195;289;Leicht bewoelkt;8;8;0
22.11.2018 13:00;807;355;452;Leicht bewoelkt;8;8;0
22.11.2018 14:00;466;232;234;Leicht bewoelkt;8;8;0
22.11.2018 15:00;832;354;478;Leicht bewoelkt;7;7;0
22.11.2018 16:00;731;333;398;Leicht bewoelkt;6;6;0
22.11.2018 17:00;852;330;522;Leicht bewoelkt;6;5;0
22.11.2018 18:00;661;310;351;Leicht bewoelkt;5;5;0
22.11.2018 19:00;519;247;272;Leicht bewoelkt;4;4;0
22.11.2018 20:00;319;144;175;Leicht bewoelkt;4;4;0
22.11.2018 21:00;234;95;139;Leicht bewoelkt;4;4;0
22.11.2018 22:00;216;80;136;Leicht bewoelkt;4;4;0
22.11.2018 23:00;135;49;86;Leicht bewoelkt;3;3;0
23.11.2018 00:00;91;23;68;Leicht bewoelkt;3;3;0
23.11.2018 01:00;53;15;38;Leicht bewoelkt;3;3;0
23.11.2018 02:00;24;14;10;Leicht bewoelkt;3;3;0
23.11.2018 03:00;6;3;3;Leicht bewoelkt;2;2;0
23.11.2018 04:00;13;9;4;Leicht bewoelkt;2;2;0
23.11.2018 05:00;29;13;16;Leicht bewoelkt;2;2;0
23.11.2018 06:00;129;75;54;Leicht bewoelkt;2;2;0
23.11.2018 07:00;775;506;269;Leicht bewoelkt;3;3;0
23.11.2018 08:00;588;322;266;Leicht bewoelkt;4;4;0
23.11.2018 09:00;549;346;203;Leicht bewoelkt;5;5;0
23.11.2018 10:00;359;200;159;Leicht bewoelkt;6;6;0
23.11.2018 11:00;479;237;242;Leicht bewoelkt;7;7;0
23.11.2018 12:00;580;272;308;Leicht bewoelkt;9;8;0
23.11.2018 13:00;750;297;453;Leicht bewoelkt;8;8;0
23.11.2018 14:00;526;253;273;Leicht bewoelkt;8;7;0
23.11.2018 15:00;586;287;299;Leicht bewoelkt;8;7;0
23.11.2018 16:00;588;269;319;Leicht bewoelkt;7;6;0
23.11.2018 17:00;623;288;335;Bedeckt;6;5;0
23.11.2018 18:00;527;244;283;Bedeckt;6;5;0
23.11.2018 19:00;408;194;214;Bedeckt;5;4;0
23.11.2018 20:00;301;128;173;Leicht bewoelkt;5;4;0
23.11.2018 21:00;199;95;104;Leicht bewoelkt;4;4;0
23.11.2018 22:00;184;68;116;Leicht bewoelkt;4;4;0
23.11.2018 23:00;163;58;105;Leicht bewoelkt;4;4;0
24.11.2018 00:00;110;54;56;Leicht bewoelkt;4;3;0
24.11.2018 01:00;89;30;59;Leicht bewoelkt;4;3;0
24.11.2018 02:00;58;23;35;Bedeckt;4;3;0
24.11.2018 03:00;31;12;19;Bedeckt;3;3;0
24.11.2018 04:00;15;10;5;Bedeckt;3;3;0
24.11.2018 05:00;21;9;12;Nieselregen;3;3;0
24.11.2018 06:00;39;27;12;Nieselregen;4;3;0
24.11.2018 07:00;48;29;19;Nieselregen;4;3;0
24.11.2018 08:00;137;90;47;Bedeckt;5;4;0
24.11.2018 09:00;241;156;85;Bedeckt;6;5;0
24.11.2018 10:00;312;172;140;Bedeckt;6;5;0
24.11.2018 11:00;378;228;150;Stellenweiser Regenfall;7;6;0
24.11.2018 12:00;407;209;198;Stellenweiser Regenfall;8;7;0
24.11.2018 13:00;478;256;222;Stellenweiser Regenfall;8;7;0
24.11.2018 14:00;436;228;208;Leicht bewoelkt;7;7;0
24.11.2018 15:00;430;185;245;Leicht bewoelkt;7;7;0
24.11.2018 16:00;439;196;243;Leicht bewoelkt;7;6;0
24.11.2018 17:00;389;174;215;Leicht bewoelkt;6;5;0
24.11.2018 18:00;351;150;201;Leicht bewoelkt;5;5;0
24.11.2018 19:00;305;178;127;Leicht bewoelkt;5;4;0
24.11.2018 20:00;278;128;150;Leicht bewoelkt;4;4;0
24.11.2018 21:00;169;82;87;Leicht bewoelkt;4;4;0
24.11.2018 22:00;183;71;112;Leicht bewoelkt;4;4;0
24.11.2018 23:00;144;56;88;Leicht bewoelkt;4;3;0
25.11.2018 00:00;151;65;86;Leicht bewoelkt;4;3;0
25.11.2018 01:00;152;64;88;Leicht bewoelkt;3;3;0
25.11.2018 02:00;65;27;38;Leicht bewoelkt;3;3;0
25.11.2018 03:00;58;15;43;Leicht bewoelkt;3;2;0
25.11.2018 04:00;29;13;16;Leicht bewoelkt;3;2;0
25.11.2018 05:00;16;9;7;Leicht bewoelkt;3;2;0
25.11.2018 06:00;18;12;6;Leicht bewoelkt;2;1;0
25.11.2018 07:00;34;16;18;Leicht bewoelkt;3;2;0
25.11.2018 08:00;50;27;23;Leicht bewoelkt;4;3;0
25.11.2018 09:00;136;93;43;Leicht bewoelkt;5;4;0
25.11.2018 10:00;117;61;56;Leicht bewoelkt;6;5;0
25.11.2018 11:00;184;84;100;Leicht bewoelkt;7;6;0
25.11.2018 12:00;160;68;92;Leicht bewoelkt;8;7;0
25.11.2018 13:00;260;129;131;Leicht bewoelkt;8;6;0
25.11.2018 14:00;261;130;131;Leicht bewoelkt;7;6;0
25.11.2018 15:00;246;116;130;Leicht bewoelkt;7;5;0
25.11.2018 16:00;325;180;145;Leicht bewoelkt;6;4;0
25.11.2018 17:00;252;122;130;Leicht bewoelkt;5;4;0
25.11.2018 18:00;231;104;127;Leicht bewoelkt;4;3;0
25.11.2018 19:00;216;87;129;Leicht bewoelkt;4;2;0
25.11.2018 20:00;139;60;79;Leichter Nebel;3;2;0
25.11.2018 21:00;109;58;51;Leichter Nebel;2;2;0
25.11.2018 22:00;106;40;66;Leichter Nebel;3;2;0
25.11.2018 23:00;64;23;41;Bedeckt;3;2;0
26.11.2018 00:00;33;14;19;Bedeckt;3;3;0
26.11.2018 01:00;17;5;12;Bedeckt;3;3;0
26.11.2018 02:00;7;2;5;Bedeckt;4;3;0
26.11.2018 03:00;1;1;0;Bedeckt;4;3;0
26.11.2018 04:00;12;11;1;Bedeckt;4;2;0
26.11.2018 05:00;36;21;15;Stellenweiser Regenfall;4;2;0
26.11.2018 06:00;133;83;50;Stellenweiser Regenfall;4;2;0
26.11.2018 07:00;857;537;320;Stellenweiser Regenfall;4;2;0
26.11.2018 08:00;601;346;255;Nieselregen;4;1;0
26.11.2018 09:00;572;374;198;Nieselregen;4;1;0
26.11.2018 10:00;323;182;141;Nieselregen;4;2;0
26.11.2018 11:00;460;213;247;Nieselregen;5;2;0
26.11.2018 12:00;494;221;273;Nieselregen;5;2;0
26.11.2018 13:00;714;307;407;Nieselregen;5;3;0
26.11.2018 14:00;455;217;238;Bedeckt;5;3;0
26.11.2018 15:00;725;328;397;Bedeckt;5;3;0
26.11.2018 16:00;648;308;340;Bedeckt;5;3;0
26.11.2018 17:00;792;361;431;Bedeckt;4;3;0
26.11.2018 18:00;618;278;340;Bedeckt;4;3;0
26.11.2018 19:00;578;272;306;Bedeckt;4;3;0
26.11.2018 20:00;389;196;193;Bedeckt;4;3;0
26.11.2018 21:00;192;74;118;Bedeckt;4;3;0
26.11.2018 22:00;245;92;153;Bedeckt;4;3;0
26.11.2018 23:00;111;45;66;Leichter Eisregen;4;3;0
27.11.2018 00:00;46;15;31;Leichter Eisregen;4;3;0
27.11.2018 01:00;19;9;10;Leichter Eisregen;3;3;0
27.11.2018 02:00;10;3;7;Bedeckt;3;2;0
27.11.2018 03:00;4;1;3;Bedeckt;3;2;0
27.11.2018 04:00;6;5;1;Bedeckt;3;2;0
27.11.2018 05:00;39;27;12;Starker Schneefall;3;2;0
27.11.2018 06:00;122;71;51;Starker Schneefall;3;2;0
27.11.2018 07:00;750;489;261;Starker Schneefall;3;2;0
27.11.2018 08:00;600;334;266;Leichter Schneefall;3;2;0
27.11.2018 09:00;589;366;223;Leichter Schneefall;3;3;0
27.11.2018 10:00;261;168;93;Leichter Schneefall;3;3;0
27.11.2018 11:00;428;205;223;Starker Schneefall;4;4;0
27.11.2018 12:00;430;187;243;Starker Schneefall;4;4;0
27.11.2018 13:00;572;237;335;Starker Schneefall;4;4;0
27.11.2018 14:00;346;165;181;Leichter Eisregen;4;4;0
27.11.2018 15:00;717;360;357;Leichter Eisregen;4;4;0
27.11.2018 16:00;603;280;323;Leichter Eisregen;4;4;0
27.11.2018 17:00;772;329;443;Leichter Eisregen;4;4;0
27.11.2018 18:00;591;256;335;Leichter Eisregen;3;3;0
27.11.2018 19:00;536;246;290;Leichter Eisregen;3;3;0
27.11.2018 20:00;330;158;172;Leichter Eisregen;2;2;0
27.11.2018 21:00;226;108;118;Leichter Eisregen;2;2;0
27.11.2018 22:00;221;70;151;Leichter Eisregen;1;1;0
27.11.2018 23:00;122;49;73;Leichter Nebel;1;1;0
28.11.2018 00:00;71;33;38;Leichter Nebel;0;0;0
28.11.2018 01:00;33;12;21;Leichter Nebel;1;1;0
28.11.2018 02:00;3;1;2;Stellenweise leichter Schneefall;1;1;0
28.11.2018 03:00;4;1;3;Stellenweise leichter Schneefall;1;1;0
28.11.2018 04:00;8;5;3;Stellenweise leichter Schneefall;1;1;0
28.11.2018 05:00;34;22;12;Leichter Nebel;1;1;0
28.11.2018 06:00;133;73;60;Leichter Nebel;1;1;0
28.11.2018 07:00;882;623;259;Leichter Nebel;2;1;0
28.11.2018 08:00;635;380;255;Leicht bewoelkt;3;2;0
28.11.2018 09:00;610;383;227;Leicht bewoelkt;3;3;0
28.11.2018 10:00;329;183;146;Leicht bewoelkt;4;4;0
28.11.2018 11:00;480;205;275;Leicht bewoelkt;5;5;0
28.11.2018 12:00;496;223;273;Leicht bewoelkt;6;6;0
28.11.2018 13:00;747;357;390;Leicht bewoelkt;6;6;0
28.11.2018 14:00;485;239;246;Bewoelkt;6;6;0
28.11.2018 15:00;700;297;403;Bewoelkt;7;6;0
28.11.2018 16:00;674;304;370;Bewoelkt;6;6;0
28.11.2018 17:00;835;347;488;Leicht bewoelkt;6;5;0
28.11.2018 18:00;666;275;391;Leicht bewoelkt;5;5;0
28.11.2018 19:00;568;232;336;Leicht bewoelkt;4;4;0
28.11.2018 20:00;417;227;190;Leicht bewoelkt;3;3;0
28.11.2018 21:00;238;114;124;Leicht bewoelkt;2;2;0
28.11.2018 22:00;222;82;140;Leicht bewoelkt;2;2;0
28.11.2018 23:00;156;61;95;Leicht bewoelkt;3;3;0
29.11.2018 00:00;80;19;61;Leicht bewoelkt;3;3;0
29.11.2018 01:00;26;9;17;Leicht bewoelkt;3;3;0
29.11.2018 02:00;16;7;9;Leicht bewoelkt;4;4;0
29.11.2018 03:00;12;9;3;Leicht bewoelkt;4;4;0
29.11.2018 04:00;8;6;2;Leicht bewoelkt;4;4;0
29.11.2018 05:00;31;23;8;Leicht bewoelkt;4;4;0
29.11.2018 06:00;126;70;56;Leicht bewoelkt;4;4;0
29.11.2018 07:00;886;561;325;Leicht bewoelkt;5;4;0
29.11.2018 08:00;621;365;256;Leicht bewoelkt;5;5;0
29.11.2018 09:00;613;413;200;Leicht bewoelkt;6;6;0
29.11.2018 10:00;312;178;134;Leicht bewoelkt;7;7;0
29.11.2018 11:00;499;249;250;Leicht bewoelkt;8;8;0
29.11.2018 12:00;561;227;334;Leicht bewoelkt;10;9;0
29.11.2018 13:00;767;342;425;Leicht bewoelkt;10;9;0
29.11.2018 14:00;476;231;245;Leicht bewoelkt;10;9;0
29.11.2018 15:00;798;368;430;Leicht bewoelkt;10;9;0
29.11.2018 16:00;702;343;359;Leicht bewoelkt;9;9;0
29.11.2018 17:00;814;361;453;Leicht bewoelkt;9;9;0
29.11.2018 18:00;692;346;346;Leicht bewoelkt;8;8;0
29.11.2018 19:00;543;262;281;Leicht bewoelkt;8;8;0
29.11.2018 20:00;378;160;218;Leicht bewoelkt;8;7;0
29.11.2018 21:00;327;116;211;Leicht bewoelkt;7;7;0
29.11.2018 22:00;250;91;159;Leicht bewoelkt;7;7;0
29.11.2018 23:00;143;47;96;Leicht bewoelkt;6;6;0
30.11.2018 00:00;72;22;50;Leicht bewoelkt;6;6;0
30.11.2018 01:00;55;9;46;Leicht bewoelkt;6;5;0
30.11.2018 02:00;24;7;17;Leicht bewoelkt;6;5;0
30.11.2018 03:00;13;5;8;Leicht bewoelkt;6;5;0
30.11.2018 04:00;4;3;1;Leicht bewoelkt;6;5;0
30.11.2018 05:00;33;22;11;Leicht bewoelkt;6;5;0
30.11.2018 06:00;130;67;63;Leicht bewoelkt;6;5;0
30.11.2018 07:00;809;512;297;Leicht bewoelkt;6;5;0
30.11.2018 08:00;533;314;219;Leicht bewoelkt;7;6;0
30.11.2018 09:00;527;344;183;Leicht bewoelkt;7;6;0
30.11.2018 10:00;350;206;144;Leicht bewoelkt;8;7;0
30.11.2018 11:00;476;218;258;Leicht bewoelkt;8;7;0
30.11.2018 12:00;629;286;343;Leicht bewoelkt;9;7;0
30.11.2018 13:00;776;296;480;Leicht bewoelkt;8;7;0
30.11.2018 14:00;512;246;266;Nieselregen;8;6;0
30.11.2018 15:00;510;221;289;Nieselregen;7;6;0
30.11.2018 16:00;513;245;268;Nieselregen;7;6;0
30.11.2018 17:00;448;204;244;Leichter Regenfall;6;5;0
30.11.2018 18:00;434;201;233;Leichter Regenfall;6;5;0
30.11.2018 19:00;364;181;183;Leichter Regenfall;6;5;0
30.11.2018 20:00;247;137;110;Bedeckt;6;4;0
30.11.2018 21:00;166;73;93;Bedeckt;6;4;0
30.11.2018 22:00;165;73;92;Bedeckt;6;4;0
30.11.2018 23:00;142;37;105;Leichter Regenfall;5;4;0
01.12.2018 00:00;113;27;86;Leichter Regenfall;5;3;0
01.12.2018 01:00;70;16;54;Leichter Regenfall;5;3;0
01.12.2018 02:00;57;9;48;Bewoelkt;5;3;0
01.12.2018 03:00;41;11;30;Bewoelkt;5;4;0
01.12.2018 04:00;22;8;14;Bewoelkt;5;4;0
01.12.2018 05:00;17;12;5;Stellenweiser Regenfall;5;4;0
01.12.2018 06:00;37;21;16;Stellenweiser Regenfall;5;4;0
01.12.2018 07:00;55;31;24;Stellenweiser Regenfall;6;5;0
01.12.2018 08:00;164;94;70;Leicht bewoelkt;6;5;0
01.12.2018 09:00;263;185;78;Leicht bewoelkt;6;6;0
01.12.2018 10:00;362;220;142;Leicht bewoelkt;7;6;0
01.12.2018 11:00;444;243;201;Leicht bewoelkt;7;7;0
01.12.2018 12:00;484;234;250;Leicht bewoelkt;8;7;0
01.12.2018 13:00;460;231;229;Leicht bewoelkt;8;7;0
01.12.2018 14:00;481;204;277;Leicht bewoelkt;7;7;0
01.12.2018 15:00;438;228;210;Leicht bewoelkt;7;7;0
01.12.2018 16:00;416;199;217;Leicht bewoelkt;7;6;0
01.12.2018 17:00;452;220;232;Leicht bewoelkt;6;5;0
01.12.2018 18:00;362;205;157;Leicht bewoelkt;5;5;0
01.12.2018 19:00;323;179;144;Leicht bewoelkt;5;4;0
01.12.2018 20:00;210;80;130;Leicht bewoelkt;4;3;0
01.12.2018 21:00;243;97;146;Leicht bewoelkt;3;3;0
01.12.2018 22:00;219;63;156;Leicht bewoelkt;4;3;0
01.12.2018 23:00;169;54;115;Leicht bewoelkt;4;3;0
02.12.2018 00:00;148;50;98;Leicht bewoelkt;4;4;0
02.12.2018 01:00;110;36;74;Leicht bewoelkt;5;4;0
02.12.2018 02:00;71;30;41;Bewoelkt;5;4;0
02.12.2018 03:00;57;20;37;Bewoelkt;6;5;0
02.12.2018 04:00;32;8;24;Bewoelkt;6;4;0
02.12.2018 05:00;28;10;18;Leicht bewoelkt;5;4;0
02.12.2018 06:00;18;6;12;Leicht bewoelkt;5;4;0
02.12.2018 07:00;38;16;22;Leicht bewoelkt;5;3;0
02.12.2018 08:00;38;18;20;Nieselregen;5;3;1
02.12.2018 09:00;115;69;46;Nieselregen;6;3;1
02.12.2018 10:00;95;65;30;Nieselregen;6;4;1
02.12.2018 11:00;104;54;50;Maessiger Regenfall;7;4;1
02.12.2018 12:00;126;71;55;Maessiger Regenfall;7;5;1
02.12.2018 13:00;135;72;63;Maessiger Regenfall;8;5;1
02.12.2018 14:00;175;80;95;Bedeckt;8;6;1
02.12.2018 15:00;164;71;93;Bedeckt;9;6;1
02.12.2018 16:00;200;102;98;Bedeckt;8;6;1
02.12.2018 17:00;224;100;124;Maessiger Regenfall;8;6;1
02.12.2018 18:00;160;77;83;Maessiger Regenfall;7;6;1
02.12.2018 19:00;149;78;71;Maessiger Regenfall;6;5;1
02.12.2018 20:00;137;53;84;Maessiger bis starker Regen mit Gewitter;5;5;1
02.12.2018 21:00;77;22;55;Maessiger bis starker Regen mit Gewitter;4;4;1
02.12.2018 22:00;82;37;45;Maessiger bis starker Regen mit Gewitter;6;5;1
02.12.2018 23:00;38;18;20;Maessiger bis starker Regenschauer;7;6;0
03.12.2018 00:00;17;4;13;Maessiger bis starker Regenschauer;9;7;0
03.12.2018 01:00;11;1;10;Maessiger bis starker Regenschauer;9;8;1
03.12.2018 02:00;8;5;3;Stellenweise Gewitter und Niederschlaege;10;8;1
03.12.2018 03:00;5;4;1;Stellenweise Gewitter und Niederschlaege;11;9;2
03.12.2018 04:00;8;3;5;Stellenweise Gewitter und Niederschlaege;11;9;2
03.12.2018 05:00;36;23;13;Maessiger bis starker Regen mit Gewitter;11;9;1
03.12.2018 06:00;124;74;50;Maessiger bis starker Regen mit Gewitter;11;9;1
03.12.2018 07:00;769;527;242;Maessiger bis starker Regen mit Gewitter;11;9;1
03.12.2018 08:00;541;297;244;Stellenweise Gewitter und Niederschlaege;11;9;1
03.12.2018 09:00;560;359;201;Stellenweise Gewitter und Niederschlaege;12;9;1
03.12.2018 10:00;343;204;139;Stellenweise Gewitter und Niederschlaege;12;10;1
03.12.2018 11:00;413;179;234;Maessiger bis starker Regenschauer;12;10;1
03.12.2018 12:00;479;226;253;Maessiger bis starker Regenschauer;12;10;1
03.12.2018 13:00;697;298;399;Maessiger bis starker Regenschauer;12;10;1
03.12.2018 14:00;457;227;230;Leichter Regenschauer;12;10;1
03.12.2018 15:00;716;326;390;Leichter Regenschauer;12;10;1
03.12.2018 16:00;546;252;294;Leichter Regenschauer;12;10;1
03.12.2018 17:00;741;342;399;Maessiger bis starker Regen mit Gewitter;12;10;0
03.12.2018 18:00;586;279;307;Maessiger bis starker Regen mit Gewitter;12;10;0
03.12.2018 19:00;513;205;308;Maessiger bis starker Regen mit Gewitter;12;10;1
03.12.2018 20:00;266;96;170;Stellenweise Gewitter und Niederschlaege;12;9;1
03.12.2018 21:00;204;77;127;Stellenweise Gewitter und Niederschlaege;12;9;2
03.12.2018 22:00;141;58;83;Stellenweise Gewitter und Niederschlaege;11;9;1
03.12.2018 23:00;89;29;60;Maessiger bis starker Regen mit Gewitter;11;9;1
04.12.2018 00:00;42;23;19;Maessiger bis starker Regen mit Gewitter;11;8;1
04.12.2018 01:00;11;4;7;Maessiger bis starker Regen mit Gewitter;11;8;1
04.12.2018 02:00;14;6;8;Leicht bewoelkt;10;7;0
04.12.2018 03:00;0;0;0;Leicht bewoelkt;10;7;0
04.12.2018 04:00;4;3;1;Leicht bewoelkt;9;7;0
04.12.2018 05:00;46;30;16;Leichter Regenschauer;9;6;1
04.12.2018 06:00;103;66;37;Leichter Regenschauer;9;6;1
04.12.2018 07:00;775;507;268;Leichter Regenschauer;9;6;1
04.12.2018 08:00;635;355;280;Stellenweiser Regenfall;9;6;1
04.12.2018 09:00;752;490;262;Stellenweiser Regenfall;9;6;0
04.12.2018 10:00;467;295;172;Stellenweiser Regenfall;9;6;0
04.12.2018 11:00;500;229;271;Leichter Regenschauer;9;7;0
04.12.2018 12:00;471;188;283;Leichter Regenschauer;10;7;0
04.12.2018 13:00;690;291;399;Leichter Regenschauer;10;7;0
04.12.2018 14:00;432;210;222;Leichter Regenschauer;10;7;0
04.12.2018 15:00;707;297;410;Leichter Regenschauer;10;7;1
04.12.2018 16:00;573;277;296;Leichter Regenschauer;9;7;1
04.12.2018 17:00;654;273;381;Maessiger bis starker Regenschauer;9;7;1
04.12.2018 18:00;559;257;302;Maessiger bis starker Regenschauer;8;7;1
04.12.2018 19:00;511;229;282;Maessiger bis starker Regenschauer;8;7;1
04.12.2018 20:00;303;123;180;Maessiger bis starker Regenschauer;8;7;1
04.12.2018 21:00;223;80;143;Maessiger bis starker Regenschauer;7;7;1
04.12.2018 22:00;216;72;144;Maessiger bis starker Regenschauer;7;7;1
04.12.2018 23:00;107;34;73;Leichter Regenfall;7;7;0
05.12.2018 00:00;55;18;37;Leichter Regenfall;7;7;0
05.12.2018 01:00;18;9;9;Leichter Regenfall;6;6;0
05.12.2018 02:00;13;4;9;Stellenweiser leichter Regenfall;6;6;0
05.12.2018 03:00;8;5;3;Stellenweiser leichter Regenfall;6;6;0
05.12.2018 04:00;5;3;2;Stellenweiser leichter Regenfall;5;5;0
05.12.2018 05:00;47;26;21;Bewoelkt;5;5;0
05.12.2018 06:00;109;62;47;Bewoelkt;5;5;0
05.12.2018 07:00;913;603;310;Bewoelkt;6;6;0
05.12.2018 08:00;637;372;265;Bedeckt;6;6;0
05.12.2018 09:00;629;402;227;Bedeckt;7;7;0
05.12.2018 10:00;332;192;140;Bedeckt;8;8;0
05.12.2018 11:00;472;209;263;Stellenweiser Regenfall;9;9;0
05.12.2018 12:00;492;217;275;Stellenweiser Regenfall;10;10;0
05.12.2018 13:00;795;361;434;Stellenweiser Regenfall;10;10;0
05.12.2018 14:00;502;270;232;Stellenweiser Regenfall;10;10;0
05.12.2018 15:00;705;316;389;Stellenweiser Regenfall;10;10;0
05.12.2018 16:00;674;300;374;Stellenweiser Regenfall;9;9;0
05.12.2018 17:00;840;358;482;Leicht bewoelkt;9;9;0
05.12.2018 18:00;671;305;366;Leicht bewoelkt;8;8;0
05.12.2018 19:00;532;217;315;Leicht bewoelkt;7;7;0
05.12.2018 20:00;421;217;204;Bedeckt;6;6;0
05.12.2018 21:00;233;82;151;Bedeckt;5;5;0
05.12.2018 22:00;223;76;147;Bedeckt;6;5;0
05.12.2018 23:00;122;50;72;Bewoelkt;6;6;0
06.12.2018 00:00;88;34;54;Bewoelkt;7;6;0
06.12.2018 01:00;41;13;28;Bewoelkt;7;7;0
06.12.2018 02:00;30;27;3;Bedeckt;7;7;0
06.12.2018 03:00;12;5;7;Bedeckt;8;8;0
06.12.2018 04:00;7;3;4;Bedeckt;8;7;0
06.12.2018 05:00;32;24;8;Stellenweiser Nieselregen;7;6;0
06.12.2018 06:00;98;54;44;Stellenweiser Nieselregen;7;5;0
06.12.2018 07:00;850;565;285;Stellenweiser Nieselregen;8;5;0
06.12.2018 08:00;614;353;261;Bedeckt;8;5;0
06.12.2018 09:00;609;414;195;Bedeckt;8;6;0
06.12.2018 10:00;301;167;134;Bedeckt;9;6;0
06.12.2018 11:00;489;249;240;Leichter Regenfall;9;7;0
06.12.2018 12:00;496;201;295;Leichter Regenfall;10;8;1
06.12.2018 13:00;766;327;439;Leichter Regenfall;10;8;0
06.12.2018 14:00;443;216;227;Stellenweiser leichter Regenfall;10;9;0
06.12.2018 15:00;771;325;446;Stellenweiser leichter Regenfall;10;9;0
06.12.2018 16:00;707;318;389;Stellenweiser leichter Regenfall;10;8;0
06.12.2018 17:00;841;376;465;Bedeckt;9;8;0
06.12.2018 18:00;726;389;337;Bedeckt;8;7;0
06.12.2018 19:00;500;237;263;Bedeckt;8;6;0
06.12.2018 20:00;429;174;255;Bewoelkt;8;6;0
06.12.2018 21:00;321;114;207;Bewoelkt;7;6;0
06.12.2018 22:00;228;79;149;Bewoelkt;7;6;0
06.12.2018 23:00;142;43;99;Bewoelkt;7;6;0
07.12.2018 00:00;122;46;76;Bewoelkt;7;6;0
07.12.2018 01:00;54;25;29;Bewoelkt;8;6;0
07.12.2018 02:00;38;25;13;Bedeckt;8;6;0
07.12.2018 03:00;14;11;3;Bedeckt;9;7;0
07.12.2018 04:00;21;20;1;Bedeckt;9;7;0
07.12.2018 05:00;34;24;10;Bedeckt;9;7;0
07.12.2018 06:00;116;63;53;Bedeckt;9;8;0
07.12.2018 07:00;765;483;282;Bedeckt;10;8;0
07.12.2018 08:00;657;414;243;Bewoelkt;10;8;0
07.12.2018 09:00;574;361;213;Bewoelkt;10;8;0
07.12.2018 10:00;389;212;177;Bewoelkt;10;8;0
07.12.2018 11:00;473;238;235;Bedeckt;10;9;0
07.12.2018 12:00;638;283;355;Bedeckt;11;9;0
07.12.2018 13:00;803;330;473;Bedeckt;10;9;0
07.12.2018 14:00;598;287;311;Bewoelkt;10;9;0
07.12.2018 15:00;602;291;311;Bewoelkt;10;9;0
07.12.2018 16:00;683;292;391;Bewoelkt;10;8;0
07.12.2018 17:00;695;318;377;Leicht bewoelkt;9;8;0
07.12.2018 18:00;579;315;264;Leicht bewoelkt;9;7;0
07.12.2018 19:00;443;221;222;Leicht bewoelkt;8;7;0
07.12.2018 20:00;295;111;184;Leicht bewoelkt;7;6;0
07.12.2018 21:00;228;67;161;Leicht bewoelkt;6;6;1
07.12.2018 22:00;192;67;125;Leicht bewoelkt;6;5;1
07.12.2018 23:00;174;52;122;Maessiger Regenfall;6;4;1
08.12.2018 00:00;106;41;65;Maessiger Regenfall;7;3;1
08.12.2018 01:00;92;18;74;Maessiger Regenfall;6;3;1
08.12.2018 02:00;58;7;51;Maessiger Regenfall;6;2;1
08.12.2018 03:00;43;12;31;Maessiger Regenfall;6;1;0
08.12.2018 04:00;16;7;9;Maessiger Regenfall;6;1;0
08.12.2018 05:00;21;16;5;Leichter Regenschauer;6;1;0
08.12.2018 06:00;30;22;8;Leichter Regenschauer;6;1;0
08.12.2018 07:00;57;25;32;Leichter Regenschauer;6;1;0
08.12.2018 08:00;156;97;59;Leichter Regenschauer;6;1;0
08.12.2018 09:00;240;152;88;Leichter Regenschauer;6;1;0
08.12.2018 10:00;327;210;117;Leichter Regenschauer;6;2;0
08.12.2018 11:00;355;187;168;Stellenweiser Regenfall;6;2;0
08.12.2018 12:00;360;186;174;Stellenweiser Regenfall;7;2;0
08.12.2018 13:00;322;169;153;Stellenweiser Regenfall;7;2;0
08.12.2018 14:00;299;157;142;Bewoelkt;7;3;0
08.12.2018 15:00;281;142;139;Bewoelkt;7;3;0
08.12.2018 16:00;306;149;157;Bewoelkt;7;3;0
08.12.2018 17:00;319;145;174;Leichter Regenfall;7;3;0
08.12.2018 18:00;284;121;163;Leichter Regenfall;7;3;0
08.12.2018 19:00;220;99;121;Leichter Regenfall;7;3;0
08.12.2018 20:00;192;89;103;Bedeckt;6;4;0
08.12.2018 21:00;147;65;82;Bedeckt;5;4;0
08.12.2018 22:00;135;37;98;Bedeckt;6;4;0
08.12.2018 23:00;119;28;91;Leichter Regenfall;6;4;0
09.12.2018 00:00;111;36;75;Leichter Regenfall;7;5;0
09.12.2018 01:00;103;30;73;Leichter Regenfall;8;5;0
09.12.2018 02:00;49;19;30;Stellenweiser leichter Regenfall;8;5;0
09.12.2018 03:00;53;23;30;Stellenweiser leichter Regenfall;9;5;1
09.12.2018 04:00;9;4;5;Stellenweiser leichter Regenfall;9;5;1
09.12.2018 05:00;12;9;3;Stellenweiser leichter Regenfall;9;5;1
09.12.2018 06:00;11;9;2;Stellenweiser leichter Regenfall;9;5;1
09.12.2018 07:00;19;6;13;Stellenweiser leichter Regenfall;9;4;1
09.12.2018 08:00;23;12;11;Leichter Regenschauer;9;4;1
09.12.2018 09:00;95;53;42;Leichter Regenschauer;8;4;1
09.12.2018 10:00;119;72;47;Leichter Regenschauer;8;4;1
09.12.2018 11:00;158;80;78;Maessiger bis starker Regen mit Gewitter;8;4;1
09.12.2018 12:00;172;87;85;Maessiger bis starker Regen mit Gewitter;8;4;1
09.12.2018 13:00;190;101;89;Maessiger bis starker Regen mit Gewitter;8;3;1
09.12.2018 14:00;150;83;67;Maessiger bis starker Regen mit Gewitter;8;3;1
09.12.2018 15:00;189;99;90;Maessiger bis starker Regen mit Gewitter;8;3;1
09.12.2018 16:00;181;108;73;Maessiger bis starker Regen mit Gewitter;8;3;1
09.12.2018 17:00;177;97;80;Maessiger bis starker Regen mit Gewitter;7;3;1
09.12.2018 18:00;163;69;94;Maessiger bis starker Regen mit Gewitter;7;3;1
09.12.2018 19:00;153;74;79;Maessiger bis starker Regen mit Gewitter;7;3;1
09.12.2018 20:00;141;47;94;Maessiger bis starker Regen mit Gewitter;7;3;1
09.12.2018 21:00;72;27;45;Maessiger bis starker Regen mit Gewitter;7;3;1
09.12.2018 22:00;78;27;51;Maessiger bis starker Regen mit Gewitter;7;3;0
09.12.2018 23:00;37;15;22;Leichter Regenschauer;7;3;0
10.12.2018 00:00;16;9;7;Leichter Regenschauer;7;3;0
10.12.2018 01:00;16;4;12;Leichter Regenschauer;6;2;0
10.12.2018 02:00;8;4;4;Nieselregen;6;2;0
10.12.2018 03:00;5;1;4;Nieselregen;6;2;0
10.12.2018 04:00;5;3;2;Nieselregen;5;1;0
10.12.2018 05:00;32;22;10;Leichter Regenschauer;5;1;0
10.12.2018 06:00;129;82;47;Leichter Regenschauer;5;1;0
10.12.2018 07:00;766;471;295;Leichter Regenschauer;5;1;0
10.12.2018 08:00;560;312;248;Bewoelkt;5;1;0
10.12.2018 09:00;574;420;154;Bewoelkt;5;1;0
10.12.2018 10:00;329;199;130;Bewoelkt;5;1;0
10.12.2018 11:00;432;183;249;Leichter Regenschauer;5;1;0
10.12.2018 12:00;458;195;263;Leichter Regenschauer;6;2;0
10.12.2018 13:00;646;249;397;Leichter Regenschauer;5;2;0
10.12.2018 14:00;346;154;192;Stellenweiser Regenfall;5;2;0
10.12.2018 15:00;653;304;349;Stellenweiser Regenfall;5;2;0
10.12.2018 16:00;652;298;354;Stellenweiser Regenfall;5;1;0
10.12.2018 17:00;714;315;399;Leichter Regenschauer;5;1;0
10.12.2018 18:00;630;314;316;Leichter Regenschauer;4;0;0
10.12.2018 19:00;442;204;238;Leichter Regenschauer;4;0;0
10.12.2018 20:00;304;141;163;Bewoelkt;4;0;0
10.12.2018 21:00;247;83;164;Bewoelkt;4;-1;0
10.12.2018 22:00;162;65;97;Bewoelkt;3;-1;0
10.12.2018 23:00;115;36;79;Leichte Eisregen;3;-1;0
11.12.2018 00:00;42;16;26;Leichte Eisregen;3;-1;0
11.12.2018 01:00;17;6;11;Leichte Eisregen;3;-1;0
11.12.2018 02:00;4;2;2;Leichte Eisregen;2;-1;0
11.12.2018 03:00;5;2;3;Leichte Eisregen;2;-1;0
11.12.2018 04:00;11;7;4;Leichte Eisregen;2;-1;0
11.12.2018 05:00;34;28;6;Maessige bis starke Schneefaelle;1;-1;0
11.12.2018 06:00;121;75;46;Maessige bis starke Schneefaelle;1;-1;0
11.12.2018 07:00;828;552;276;Maessige bis starke Schneefaelle;1;-1;0
11.12.2018 08:00;663;372;291;Maessige bis starke Schneefaelle;2;-1;0
11.12.2018 09:00;598;358;240;Maessige bis starke Schneefaelle;2;-1;0
11.12.2018 10:00;326;192;134;Maessige bis starke Schneefaelle;2;0;0
11.12.2018 11:00;474;221;253;Maessige bis starke Schneefaelle;3;1;0
11.12.2018 12:00;483;220;263;Maessige bis starke Schneefaelle;3;1;0
11.12.2018 13:00;693;297;396;Maessige bis starke Schneefaelle;3;1;0
11.12.2018 14:00;473;204;269;Maessige bis starke Schneefaelle;3;1;0
11.12.2018 15:00;800;369;431;Maessige bis starke Schneefaelle;3;2;0
11.12.2018 16:00;676;316;360;Maessige bis starke Schneefaelle;3;1;0
11.12.2018 17:00;863;412;451;Maessige bis starke Schneefaelle;2;1;0
11.12.2018 18:00;662;312;350;Maessige bis starke Schneefaelle;2;0;0
11.12.2018 19:00;593;258;335;Maessige bis starke Schneefaelle;1;0;0
11.12.2018 20:00;410;175;235;Maessige bis starke Schneefaelle;1;-1;0
11.12.2018 21:00;263;78;185;Maessige bis starke Schneefaelle;0;-2;0
11.12.2018 22:00;222;64;158;Maessige bis starke Schneefaelle;0;-2;0
11.12.2018 23:00;148;53;95;Stellenweise leichter Schneefall;-1;-2;0
12.12.2018 00:00;50;19;31;Stellenweise leichter Schneefall;-1;-3;0
12.12.2018 01:00;26;5;21;Stellenweise leichter Schneefall;-1;-3;0
12.12.2018 02:00;15;4;11;Leicht bewoelkt;-1;-2;0
12.12.2018 03:00;3;0;3;Leicht bewoelkt;-1;-2;0
12.12.2018 04:00;5;4;1;Leicht bewoelkt;-1;-2;0
12.12.2018 05:00;33;20;13;Leicht bewoelkt;-1;-2;0
12.12.2018 06:00;135;89;46;Leicht bewoelkt;-1;-2;0
12.12.2018 07:00;894;566;328;Leicht bewoelkt;0;-1;0
12.12.2018 08:00;595;354;241;Leicht bewoelkt;0;-1;0
12.12.2018 09:00;574;357;217;Leicht bewoelkt;1;0;0
12.12.2018 10:00;318;176;142;Leicht bewoelkt;2;0;0
12.12.2018 11:00;451;214;237;Leicht bewoelkt;2;1;0
12.12.2018 12:00;482;219;263;Leicht bewoelkt;3;1;0
12.12.2018 13:00;762;334;428;Leicht bewoelkt;3;1;0
12.12.2018 14:00;482;261;221;Leicht bewoelkt;3;0;0
12.12.2018 15:00;633;267;366;Leicht bewoelkt;3;0;0
12.12.2018 16:00;678;305;373;Leicht bewoelkt;3;-1;0
12.12.2018 17:00;805;342;463;Leicht bewoelkt;2;-1;0
12.12.2018 18:00;627;287;340;Leicht bewoelkt;2;-2;0
12.12.2018 19:00;458;200;258;Leicht bewoelkt;1;-3;0
12.12.2018 20:00;416;176;240;Leicht bewoelkt;1;-3;0
12.12.2018 21:00;254;102;152;Leicht bewoelkt;0;-4;0
12.12.2018 22:00;217;69;148;Leicht bewoelkt;0;-4;0
12.12.2018 23:00;161;57;104;Leicht bewoelkt;0;-4;0
13.12.2018 00:00;85;24;61;Leicht bewoelkt;0;-4;0
13.12.2018 01:00;41;9;32;Leicht bewoelkt;0;-4;0
13.12.2018 02:00;22;13;9;Leicht bewoelkt;0;-4;0
13.12.2018 03:00;13;7;6;Leicht bewoelkt;0;-4;0
13.12.2018 04:00;15;10;5;Leicht bewoelkt;0;-4;0
13.12.2018 05:00;32;20;12;Leicht bewoelkt;0;-4;0
13.12.2018 06:00;139;79;60;Leicht bewoelkt;-1;-4;0
13.12.2018 07:00;826;517;309;Leicht bewoelkt;0;-4;0
13.12.2018 08:00;531;288;243;Leicht bewoelkt;0;-4;0
13.12.2018 09:00;610;422;188;Leicht bewoelkt;0;-4;0
13.12.2018 10:00;309;171;138;Leicht bewoelkt;0;-3;0
13.12.2018 11:00;475;239;236;Sonnig;1;-2;0
13.12.2018 12:00;463;194;269;Sonnig;2;-2;0
13.12.2018 13:00;712;287;425;Sonnig;2;-2;0
13.12.2018 14:00;482;240;242;Sonnig;2;-2;0
13.12.2018 15:00;783;359;424;Sonnig;2;-2;0
13.12.2018 16:00;618;308;310;Sonnig;1;-3;0
13.12.2018 17:00;789;376;413;Sonnig;1;-3;0
13.12.2018 18:00;644;301;343;Sonnig;0;-4;0
13.12.2018 19:00;425;178;247;Sonnig;0;-4;0
13.12.2018 20:00;359;123;236;Leicht bewoelkt;-1;-4;0
13.12.2018 21:00;253;106;147;Leicht bewoelkt;-1;-4;0
13.12.2018 22:00;219;84;135;Leicht bewoelkt;-1;-4;0
13.12.2018 23:00;130;46;84;Leicht bewoelkt;-1;-4;0
14.12.2018 00:00;70;31;39;Leicht bewoelkt;-1;-4;0
14.12.2018 01:00;54;18;36;Leicht bewoelkt;-1;-4;0
14.12.2018 02:00;25;17;8;Leicht bewoelkt;-2;-5;0
14.12.2018 03:00;21;16;5;Leicht bewoelkt;-2;-5;0
14.12.2018 04:00;4;4;0;Leicht bewoelkt;-2;-5;0
14.12.2018 05:00;26;17;9;Leicht bewoelkt;-2;-5;0
14.12.2018 06:00;133;76;57;Leicht bewoelkt;-2;-5;0
14.12.2018 07:00;711;458;253;Leicht bewoelkt;-1;-5;0
14.12.2018 08:00;571;314;257;Leicht bewoelkt;-1;-4;0
14.12.2018 09:00;567;355;212;Leicht bewoelkt;-1;-3;0
14.12.2018 10:00;366;221;145;Leicht bewoelkt;0;-3;0
14.12.2018 11:00;448;206;242;Sonnig;1;-2;0
14.12.2018 12:00;554;256;298;Sonnig;1;-1;0
14.12.2018 13:00;780;315;465;Sonnig;1;-1;0
14.12.2018 14:00;535;246;289;Sonnig;1;-1;0
14.12.2018 15:00;571;280;291;Sonnig;1;-1;0
14.12.2018 16:00;592;294;298;Sonnig;1;-2;0
14.12.2018 17:00;583;310;273;Sonnig;0;-2;0
14.12.2018 18:00;494;221;273;Sonnig;0;-3;0
14.12.2018 19:00;387;199;188;Sonnig;-1;-3;0
14.12.2018 20:00;270;125;145;Leicht bewoelkt;-2;-4;0
14.12.2018 21:00;227;86;141;Leicht bewoelkt;-3;-4;0
14.12.2018 22:00;203;73;130;Leicht bewoelkt;-3;-3;0
14.12.2018 23:00;181;45;136;Sonnig;-2;-2;0
15.12.2018 00:00;125;39;86;Sonnig;-2;-2;0
15.12.2018 01:00;78;28;50;Sonnig;-1;-2;0
15.12.2018 02:00;75;28;47;Sonnig;-1;-2;0
15.12.2018 03:00;37;16;21;Sonnig;-1;-2;0
15.12.2018 04:00;29;13;16;Sonnig;-1;-2;0
15.12.2018 05:00;21;11;10;Sonnig;-2;-3;0
15.12.2018 06:00;35;24;11;Sonnig;-2;-3;0
15.12.2018 07:00;55;34;21;Sonnig;-2;-3;0
15.12.2018 08:00;120;68;52;Leicht bewoelkt;-1;-2;0
15.12.2018 09:00;216;141;75;Leicht bewoelkt;-1;-2;0
15.12.2018 10:00;292;177;115;Leicht bewoelkt;0;-1;0
15.12.2018 11:00;294;182;112;Leicht bewoelkt;1;0;0
15.12.2018 12:00;380;213;167;Leicht bewoelkt;2;0;0
15.12.2018 13:00;367;190;177;Leicht bewoelkt;1;0;0
15.12.2018 14:00;356;178;178;Sonnig;1;-1;0
15.12.2018 15:00;360;177;183;Sonnig;1;-1;0
15.12.2018 16:00;347;164;183;Sonnig;0;-2;0
15.12.2018 17:00;329;150;179;Leicht bewoelkt;0;-3;0
15.12.2018 18:00;302;127;175;Leicht bewoelkt;-1;-4;0
15.12.2018 19:00;301;171;130;Leicht bewoelkt;-2;-4;0
15.12.2018 20:00;243;112;131;Leicht bewoelkt;-3;-5;0
15.12.2018 21:00;174;70;104;Leicht bewoelkt;-4;-5;0
15.12.2018 22:00;176;43;133;Leicht bewoelkt;-4;-4;0
15.12.2018 23:00;136;37;99;Leicht bewoelkt;-3;-3;0
16.12.2018 00:00;107;36;71;Leicht bewoelkt;-2;-2;0
16.12.2018 01:00;93;31;62;Leicht bewoelkt;-1;-1;0
16.12.2018 02:00;62;23;39;Bedeckt;-1;-1;0
16.12.2018 03:00;52;19;33;Bedeckt;-1;-1;0
16.12.2018 04:00;17;14;3;Bedeckt;0;-1;0
16.12.2018 05:00;16;10;6;Stellenweise starker Schneefall;0;-1;0
16.12.2018 06:00;19;10;9;Stellenweise starker Schneefall;0;-1;1
16.12.2018 07:00;25;11;14;Stellenweise starker Schneefall;1;0;1
16.12.2018 08:00;40;11;29;Starker Schneefall;2;0;1
16.12.2018 09:00;68;41;27;Starker Schneefall;3;1;1
16.12.2018 10:00;90;53;37;Starker Schneefall;3;1;0
16.12.2018 11:00;86;46;40;Leichter Regenfall;4;2;0
16.12.2018 12:00;113;65;48;Leichter Regenfall;5;3;0
16.12.2018 13:00;102;46;56;Leichter Regenfall;5;3;0
16.12.2018 14:00;167;94;73;Bedeckt;5;3;0
16.12.2018 15:00;148;76;72;Bedeckt;5;3;0
16.12.2018 16:00;183;99;84;Bedeckt;4;3;0
16.12.2018 17:00;192;114;78;Stellenweiser Regenfall;4;2;0
16.12.2018 18:00;189;72;117;Stellenweiser Regenfall;3;2;0
16.12.2018 19:00;142;56;86;Stellenweiser Regenfall;3;2;0
16.12.2018 20:00;135;51;84;Leicht bewoelkt;2;2;0
16.12.2018 21:00;91;40;51;Leicht bewoelkt;2;2;0
16.12.2018 22:00;69;42;27;Leicht bewoelkt;2;2;0
16.12.2018 23:00;34;6;28;Leicht bewoelkt;1;1;0
17.12.2018 00:00;24;5;19;Leicht bewoelkt;1;1;0
17.12.2018 01:00;15;9;6;Leicht bewoelkt;1;1;0
17.12.2018 02:00;6;5;1;Leicht bewoelkt;1;1;0
17.12.2018 03:00;2;0;2;Leicht bewoelkt;0;0;0
17.12.2018 04:00;9;6;3;Leicht bewoelkt;0;0;0
17.12.2018 05:00;30;18;12;Leicht bewoelkt;0;0;0
17.12.2018 06:00;111;65;46;Leicht bewoelkt;0;0;0
17.12.2018 07:00;679;419;260;Leicht bewoelkt;1;0;0
17.12.2018 08:00;509;274;235;Bedeckt;1;0;0
17.12.2018 09:00;527;323;204;Bedeckt;2;1;0
17.12.2018 10:00;293;187;106;Bedeckt;2;1;0
17.12.2018 11:00;375;207;168;Bewoelkt;3;2;0
17.12.2018 12:00;449;192;257;Bewoelkt;4;2;0
17.12.2018 13:00;565;233;332;Bewoelkt;4;2;0
17.12.2018 14:00;445;200;245;Leicht bewoelkt;4;2;0
17.12.2018 15:00;656;323;333;Leicht bewoelkt;4;2;0
17.12.2018 16:00;530;260;270;Leicht bewoelkt;4;1;0
17.12.2018 17:00;714;316;398;Nieselregen;3;1;0
17.12.2018 18:00;586;272;314;Nieselregen;3;0;0
17.12.2018 19:00;485;216;269;Nieselregen;3;0;0
17.12.2018 20:00;327;118;209;Stellenweiser Nieselregen;3;0;0
17.12.2018 21:00;229;90;139;Stellenweiser Nieselregen;2;0;0
17.12.2018 22:00;185;77;108;Stellenweiser Nieselregen;2;0;0
17.12.2018 23:00;103;31;72;Bewoelkt;2;0;0
18.12.2018 00:00;64;30;34;Nieselregen;2;0;0
18.12.2018 01:00;25;14;11;Nieselregen;1;0;0
18.12.2018 02:00;25;16;9;Leicht bewoelkt;1;0;0
18.12.2018 03:00;7;6;1;Leicht bewoelkt;1;0;0
18.12.2018 04:00;6;4;2;Leicht bewoelkt;1;0;0
18.12.2018 05:00;39;23;16;Leicht bewoelkt;1;0;0
18.12.2018 06:00;103;62;41;Leicht bewoelkt;1;0;0
18.12.2018 07:00;726;470;256;Leicht bewoelkt;1;0;0
18.12.2018 08:00;601;340;261;Leicht bewoelkt;2;1;0
18.12.2018 09:00;588;383;205;Leicht bewoelkt;2;2;0
18.12.2018 10:00;335;204;131;Leicht bewoelkt;3;3;0
18.12.2018 11:00;489;234;255;Leicht bewoelkt;5;4;0
18.12.2018 12:00;459;205;254;Leicht bewoelkt;6;6;0
18.12.2018 13:00;706;273;433;Leicht bewoelkt;6;5;0
18.12.2018 14:00;432;204;228;Sonnig;6;5;0
18.12.2018 15:00;705;316;389;Sonnig;6;5;0
18.12.2018 16:00;609;295;314;Sonnig;6;5;0
18.12.2018 17:00;814;378;436;Sonnig;5;5;0
18.12.2018 18:00;625;285;340;Sonnig;5;4;0
18.12.2018 19:00;515;208;307;Sonnig;4;4;0
18.12.2018 20:00;308;130;178;Sonnig;3;3;0
18.12.2018 21:00;245;72;173;Sonnig;2;2;0
18.12.2018 22:00;216;65;151;Sonnig;2;2;0
18.12.2018 23:00;124;36;88;Leicht bewoelkt;1;1;0
19.12.2018 00:00;78;36;42;Leicht bewoelkt;1;1;0
19.12.2018 01:00;34;17;17;Leicht bewoelkt;0;0;0
19.12.2018 02:00;17;11;6;Leicht bewoelkt;0;0;0
19.12.2018 03:00;3;2;1;Leicht bewoelkt;0;0;0
19.12.2018 04:00;3;3;0;Leicht bewoelkt;0;0;0
19.12.2018 05:00;29;19;10;Leicht bewoelkt;1;1;0
19.12.2018 06:00;122;69;53;Leicht bewoelkt;1;1;0
19.12.2018 07:00;794;514;280;Leicht bewoelkt;2;2;0
19.12.2018 08:00;586;363;223;Bedeckt;2;2;0
19.12.2018 09:00;599;392;207;Bedeckt;3;3;0
19.12.2018 10:00;326;169;157;Bedeckt;4;4;0
19.12.2018 11:00;428;208;220;Bedeckt;5;5;0
19.12.2018 12:00;511;238;273;Bedeckt;5;5;0
19.12.2018 13:00;709;359;350;Bedeckt;5;5;0
19.12.2018 14:00;481;231;250;Bedeckt;5;5;0
19.12.2018 15:00;690;310;380;Bedeckt;5;4;0
19.12.2018 16:00;651;325;326;Bedeckt;5;3;0
19.12.2018 17:00;789;312;477;Leicht bewoelkt;4;2;0
19.12.2018 18:00;646;299;347;Leicht bewoelkt;3;2;0
19.12.2018 19:00;499;205;294;Leicht bewoelkt;2;1;0
19.12.2018 20:00;416;156;260;Stellenweiser Regenfall;2;1;0
19.12.2018 21:00;277;104;173;Stellenweiser Regenfall;1;1;0
19.12.2018 22:00;266;114;152;Stellenweiser Regenfall;1;1;0
19.12.2018 23:00;161;59;102;Leichter Regenfall;2;1;0
20.12.2018 00:00;126;43;83;Leichter Regenfall;2;1;0
20.12.2018 01:00;98;18;80;Leichter Regenfall;2;0;0
20.12.2018 02:00;33;13;20;Nieselregen;2;0;0
20.12.2018 03:00;17;5;12;Nieselregen;3;0;0
20.12.2018 04:00;20;16;4;Nieselregen;3;0;0
20.12.2018 05:00;41;29;12;Bewoelkt;3;0;0
20.12.2018 06:00;103;57;46;Bewoelkt;3;1;0
20.12.2018 07:00;502;239;263;Bewoelkt;4;1;0
20.12.2018 08:00;535;317;218;Bewoelkt;4;1;0
20.12.2018 09:00;743;529;214;Bewoelkt;5;2;0
20.12.2018 10:00;365;224;141;Bewoelkt;5;2;0
20.12.2018 11:00;490;243;247;Leicht bewoelkt;6;3;0
20.12.2018 12:00;638;315;323;Leicht bewoelkt;6;4;0
20.12.2018 13:00;741;294;447;Leicht bewoelkt;6;4;0
20.12.2018 14:00;548;243;305;Leicht bewoelkt;6;4;0
20.12.2018 15:00;582;253;329;Leicht bewoelkt;6;4;0
20.12.2018 16:00;608;279;329;Leicht bewoelkt;5;3;0
20.12.2018 17:00;734;348;386;Leicht bewoelkt;5;3;0
20.12.2018 18:00;623;307;316;Leicht bewoelkt;4;2;0
20.12.2018 19:00;488;238;250;Leicht bewoelkt;4;2;0
20.12.2018 20:00;322;130;192;Bewoelkt;4;2;0
20.12.2018 21:00;232;85;147;Bewoelkt;4;1;0
20.12.2018 22:00;217;77;140;Bewoelkt;4;1;0
20.12.2018 23:00;177;57;120;Stellenweiser Regenfall;4;1;0
21.12.2018 00:00;113;26;87;Stellenweiser Regenfall;4;1;0
21.12.2018 01:00;71;13;58;Stellenweiser Regenfall;4;1;0
21.12.2018 02:00;42;14;28;Stellenweiser Regenfall;4;1;0
21.12.2018 03:00;18;3;15;Stellenweiser Regenfall;4;1;0
21.12.2018 04:00;11;5;6;Stellenweiser Regenfall;4;1;0
21.12.2018 05:00;34;24;10;Leicht bewoelkt;4;1;0
21.12.2018 06:00;93;52;41;Leicht bewoelkt;4;1;0
21.12.2018 07:00;225;148;77;Leicht bewoelkt;4;1;0
21.12.2018 08:00;364;201;163;Bewoelkt;5;2;0
21.12.2018 09:00;377;241;136;Bewoelkt;5;2;0
21.12.2018 10:00;270;154;116;Bewoelkt;5;2;0
21.12.2018 11:00;293;143;150;Nieselregen;5;2;0
21.12.2018 12:00;333;158;175;Nieselregen;6;3;0
21.12.2018 13:00;313;150;163;Nieselregen;6;3;0
21.12.2018 14:00;270;119;151;Bedeckt;6;3;0
21.12.2018 15:00;277;118;159;Bedeckt;7;4;0
21.12.2018 16:00;299;139;160;Bedeckt;7;4;0
21.12.2018 17:00;308;142;166;Stellenweiser leichter Regenfall;7;5;0
21.12.2018 18:00;264;125;139;Stellenweiser leichter Regenfall;6;5;0
21.12.2018 19:00;195;76;119;Stellenweiser leichter Regenfall;5;4;0
21.12.2018 20:00;151;61;90;Bewoelkt;4;4;0
21.12.2018 21:00;103;49;54;Bewoelkt;3;3;0
21.12.2018 22:00;96;33;63;Bewoelkt;4;4;1
21.12.2018 23:00;70;25;45;Leichter Regenfall;6;4;1
22.12.2018 00:00;82;25;57;Leichter Regenfall;7;5;1
22.12.2018 01:00;33;12;21;Leichter Regenfall;8;6;1
22.12.2018 02:00;31;10;21;Maessiger Regenfall;9;7;1
22.12.2018 03:00;22;9;13;Maessiger Regenfall;11;7;1
22.12.2018 04:00;10;2;8;Maessiger Regenfall;11;7;0
22.12.2018 05:00;17;12;5;Leichter Regenfall;11;8;0
22.12.2018 06:00;30;15;15;Leichter Regenfall;11;8;0
22.12.2018 07:00;42;28;14;Leichter Regenfall;11;7;0
22.12.2018 08:00;93;58;35;Bedeckt;11;7;0
22.12.2018 09:00;168;121;47;Bedeckt;11;7;0
22.12.2018 10:00;211;108;103;Bedeckt;11;7;0
22.12.2018 11:00;323;183;140;Leichter Regenschauer;11;7;0
22.12.2018 12:00;306;170;136;Leichter Regenschauer;11;7;0
22.12.2018 13:00;321;157;164;Leichter Regenschauer;10;7;0
22.12.2018 14:00;317;162;155;Leichter Regenschauer;10;7;0
22.12.2018 15:00;339;152;187;Leichter Regenschauer;10;7;0
22.12.2018 16:00;311;149;162;Leichter Regenschauer;10;7;0
22.12.2018 17:00;242;115;127;Leichter Regenschauer;10;7;0
22.12.2018 18:00;233;110;123;Leichter Regenschauer;10;6;0
22.12.2018 19:00;177;99;78;Leichter Regenschauer;9;6;0
22.12.2018 20:00;128;58;70;Bewoelkt;9;6;0
22.12.2018 21:00;99;37;62;Bewoelkt;9;6;0
22.12.2018 22:00;106;34;72;Bewoelkt;9;6;0
22.12.2018 23:00;78;24;54;Leichter Regenschauer;9;6;0
23.12.2018 00:00;65;16;49;Leichter Regenschauer;9;6;0
23.12.2018 01:00;79;14;65;Leichter Regenschauer;9;6;0
23.12.2018 02:00;44;15;29;Bewoelkt;9;6;0
23.12.2018 03:00;36;4;32;Bewoelkt;9;6;0
23.12.2018 04:00;21;8;13;Bewoelkt;9;6;0
23.12.2018 05:00;21;8;13;Leichter Regenschauer;9;6;0
23.12.2018 06:00;16;11;5;Leichter Regenschauer;9;6;0
23.12.2018 07:00;17;11;6;Leichter Regenschauer;9;6;0
23.12.2018 08:00;29;18;11;Leichter Regenschauer;9;7;0
23.12.2018 09:00;71;42;29;Leichter Regenschauer;9;7;0
23.12.2018 10:00;76;46;30;Leichter Regenschauer;9;7;0
23.12.2018 11:00;98;43;55;Stellenweiser Regenfall;9;8;0
23.12.2018 12:00;92;51;41;Stellenweiser Regenfall;9;8;0
23.12.2018 13:00;100;54;46;Stellenweiser Regenfall;9;7;1
23.12.2018 14:00;95;48;47;Bedeckt;9;7;1
23.12.2018 15:00;77;39;38;Bedeckt;8;6;2
23.12.2018 16:00;94;48;46;Bedeckt;8;6;2
23.12.2018 17:00;72;32;40;Starker Regenfall;7;6;2
23.12.2018 18:00;73;31;42;Starker Regenfall;7;6;2
23.12.2018 19:00;37;18;19;Starker Regenfall;5;5;2
23.12.2018 20:00;43;20;23;Maessiger Regenfall;4;4;1
23.12.2018 21:00;45;22;23;Maessiger Regenfall;3;3;1
23.12.2018 22:00;28;10;18;Maessiger Regenfall;5;4;1
23.12.2018 23:00;24;4;20;Leichter Regenfall;6;5;0
24.12.2018 00:00;12;5;7;Leichter Regenfall;8;6;0
24.12.2018 01:00;16;8;8;Leichter Regenfall;9;6;0
24.12.2018 02:00;10;5;5;Bedeckt;10;7;1
24.12.2018 03:00;0;0;0;Bedeckt;11;8;1
24.12.2018 04:00;8;1;7;Bedeckt;10;7;1
24.12.2018 05:00;18;14;4;Maessiger Regenfall;10;7;1
24.12.2018 06:00;22;10;12;Maessiger Regenfall;10;7;0
24.12.2018 07:00;31;22;9;Maessiger Regenfall;9;6;1
24.12.2018 08:00;83;48;35;Bedeckt;8;6;1
24.12.2018 09:00;147;99;48;Bedeckt;7;5;1
24.12.2018 10:00;246;113;133;Bedeckt;7;5;1
24.12.2018 11:00;240;126;114;Maessiger Regenfall;7;5;1
24.12.2018 12:00;248;100;148;Maessiger Regenfall;7;5;2
24.12.2018 13:00;196;72;124;Maessiger Regenfall;6;5;1
24.12.2018 14:00;157;61;96;Teilweise maessiger Regenfall;6;5;1
24.12.2018 15:00;113;51;62;Teilweise maessiger Regenfall;6;5;1
24.12.2018 16:00;135;50;85;Teilweise maessiger Regenfall;6;5;0
24.12.2018 17:00;79;36;43;Stellenweiser Regenfall;5;5;0
24.12.2018 18:00;85;30;55;Stellenweiser Regenfall;5;4;0
24.12.2018 19:00;40;14;26;Stellenweiser Regenfall;4;3;0
24.12.2018 20:00;15;7;8;Bedeckt;3;3;0
24.12.2018 21:00;30;17;13;Bedeckt;2;2;0
24.12.2018 22:00;45;35;10;Bedeckt;2;2;0
24.12.2018 23:00;42;21;21;Leicht bewoelkt;2;2;0
25.12.2018 00:00;34;17;17;Leicht bewoelkt;2;2;0
25.12.2018 01:00;19;6;13;Leicht bewoelkt;2;2;0
25.12.2018 02:00;11;8;3;Leicht bewoelkt;2;2;0
25.12.2018 03:00;14;4;10;Leicht bewoelkt;3;3;0
25.12.2018 04:00;6;3;3;Leicht bewoelkt;2;2;0
25.12.2018 05:00;6;2;4;Leicht bewoelkt;2;2;0
25.12.2018 06:00;11;3;8;Leicht bewoelkt;2;2;0
25.12.2018 07:00;11;3;8;Leicht bewoelkt;2;2;0
25.12.2018 08:00;13;8;5;Leicht bewoelkt;2;2;0
25.12.2018 09:00;35;18;17;Leicht bewoelkt;2;2;0
25.12.2018 10:00;34;19;15;Leicht bewoelkt;3;3;0
25.12.2018 11:00;48;26;22;Leicht bewoelkt;4;4;0
25.12.2018 12:00;60;23;37;Leicht bewoelkt;5;5;0
25.12.2018 13:00;50;36;14;Leicht bewoelkt;5;5;0
25.12.2018 14:00;75;34;41;Leicht bewoelkt;5;5;0
25.12.2018 15:00;50;27;23;Leicht bewoelkt;5;5;0
25.12.2018 16:00;72;40;32;Leicht bewoelkt;5;4;0
25.12.2018 17:00;57;22;35;Leicht bewoelkt;4;4;0
25.12.2018 18:00;57;33;24;Leicht bewoelkt;4;3;0
25.12.2018 19:00;45;22;23;Leicht bewoelkt;3;3;0
25.12.2018 20:00;41;25;16;Leicht bewoelkt;3;3;0
25.12.2018 21:00;46;20;26;Leicht bewoelkt;2;2;0
25.12.2018 22:00;42;16;26;Leicht bewoelkt;2;2;0
25.12.2018 23:00;18;8;10;Leicht bewoelkt;2;2;0
26.12.2018 00:00;19;6;13;Leicht bewoelkt;2;2;0
26.12.2018 01:00;17;6;11;Leicht bewoelkt;2;2;0
26.12.2018 02:00;5;1;4;Leicht bewoelkt;1;1;0
26.12.2018 03:00;8;1;7;Leicht bewoelkt;1;1;0
26.12.2018 04:00;5;3;2;Leicht bewoelkt;1;1;0
26.12.2018 05:00;3;1;2;Leicht bewoelkt;2;2;0
26.12.2018 06:00;10;1;9;Leicht bewoelkt;2;2;0
26.12.2018 07:00;9;7;2;Leicht bewoelkt;2;2;0
26.12.2018 08:00;11;6;5;Leicht bewoelkt;3;2;0
26.12.2018 09:00;37;25;12;Leicht bewoelkt;3;3;0
26.12.2018 10:00;49;29;20;Leicht bewoelkt;4;3;0
26.12.2018 11:00;61;31;30;Leicht bewoelkt;5;4;0
26.12.2018 12:00;85;37;48;Leicht bewoelkt;5;5;0
26.12.2018 13:00;96;51;45;Leicht bewoelkt;5;4;0
26.12.2018 14:00;74;32;42;Leicht bewoelkt;5;4;0
26.12.2018 15:00;88;49;39;Leicht bewoelkt;5;3;0
26.12.2018 16:00;116;63;53;Leicht bewoelkt;4;3;0
26.12.2018 17:00;64;31;33;Leicht bewoelkt;3;2;0
26.12.2018 18:00;79;38;41;Leicht bewoelkt;2;2;0
26.12.2018 19:00;65;32;33;Leicht bewoelkt;1;1;0
26.12.2018 20:00;83;55;28;Leicht bewoelkt;0;0;0
26.12.2018 21:00;56;30;26;Leicht bewoelkt;-1;-1;0
26.12.2018 22:00;46;17;29;Leicht bewoelkt;-1;-1;0
26.12.2018 23:00;43;14;29;Leicht bewoelkt;0;0;0
27.12.2018 00:00;15;3;12;Leicht bewoelkt;0;0;0
27.12.2018 01:00;17;3;14;Leicht bewoelkt;0;0;0
27.12.2018 02:00;10;3;7;Leicht bewoelkt;0;0;0
27.12.2018 03:00;9;6;3;Leicht bewoelkt;0;0;0
27.12.2018 04:00;15;13;2;Leicht bewoelkt;0;0;0
27.12.2018 05:00;16;12;4;Leicht bewoelkt;0;0;0
27.12.2018 06:00;49;32;17;Leicht bewoelkt;0;-1;0
27.12.2018 07:00;93;56;37;Leicht bewoelkt;1;0;0
27.12.2018 08:00;99;63;36;Leicht bewoelkt;1;1;0
27.12.2018 09:00;129;102;27;Leicht bewoelkt;2;2;0
27.12.2018 10:00;171;97;74;Leicht bewoelkt;3;3;0
27.12.2018 11:00;196;119;77;Leicht bewoelkt;4;4;0
27.12.2018 12:00;233;105;128;Leicht bewoelkt;6;5;0
27.12.2018 13:00;230;113;117;Leicht bewoelkt;5;5;0
27.12.2018 14:00;222;113;109;Leicht bewoelkt;5;4;0
27.12.2018 15:00;227;108;119;Leicht bewoelkt;5;4;0
27.12.2018 16:00;240;107;133;Leicht bewoelkt;4;3;0
27.12.2018 17:00;190;68;122;Leicht bewoelkt;3;3;0
27.12.2018 18:00;193;75;118;Leicht bewoelkt;3;2;0
27.12.2018 19:00;137;52;85;Leicht bewoelkt;2;2;0
27.12.2018 20:00;237;113;124;Leicht bewoelkt;2;2;0
27.12.2018 21:00;66;34;32;Leicht bewoelkt;2;2;0
27.12.2018 22:00;82;24;58;Leicht bewoelkt;2;2;0
27.12.2018 23:00;38;15;23;Leicht bewoelkt;1;1;0
28.12.2018 00:00;23;8;15;Leicht bewoelkt;1;1;0
28.12.2018 01:00;35;5;30;Leicht bewoelkt;1;1;0
28.12.2018 02:00;14;7;7;Leicht bewoelkt;1;1;0
28.12.2018 03:00;6;5;1;Leicht bewoelkt;1;1;0
28.12.2018 04:00;5;5;0;Leicht bewoelkt;1;1;0
28.12.2018 05:00;23;11;12;Bewoelkt;1;1;0
28.12.2018 06:00;52;31;21;Bewoelkt;2;2;0
28.12.2018 07:00;81;48;33;Bewoelkt;2;2;0
28.12.2018 08:00;117;84;33;Leicht bewoelkt;3;3;0
28.12.2018 09:00;171;105;66;Leicht bewoelkt;3;3;0
28.12.2018 10:00;221;136;85;Leicht bewoelkt;4;4;0
28.12.2018 11:00;256;141;115;Leicht bewoelkt;5;5;0
28.12.2018 12:00;241;114;127;Leicht bewoelkt;6;6;0
28.12.2018 13:00;292;141;151;Leicht bewoelkt;6;6;0
28.12.2018 14:00;253;112;141;Leicht bewoelkt;6;5;0
28.12.2018 15:00;244;123;121;Leicht bewoelkt;5;5;0
28.12.2018 16:00;256;115;141;Leicht bewoelkt;4;4;0
28.12.2018 17:00;228;79;149;Leicht bewoelkt;4;3;0
28.12.2018 18:00;230;92;138;Leicht bewoelkt;3;3;0
28.12.2018 19:00;176;70;106;Leicht bewoelkt;2;2;0
28.12.2018 20:00;123;47;76;Leicht bewoelkt;2;2;0
28.12.2018 21:00;82;45;37;Leicht bewoelkt;2;2;0
28.12.2018 22:00;84;28;56;Leicht bewoelkt;2;2;0
28.12.2018 23:00;64;25;39;Leicht bewoelkt;2;2;0
29.12.2018 00:00;52;13;39;Leicht bewoelkt;2;2;0
29.12.2018 01:00;28;8;20;Leicht bewoelkt;1;1;0
29.12.2018 02:00;28;11;17;Leicht bewoelkt;1;0;0
29.12.2018 03:00;29;11;18;Leicht bewoelkt;1;0;0
29.12.2018 04:00;8;6;2;Leicht bewoelkt;0;-1;0
29.12.2018 05:00;16;6;10;Leicht bewoelkt;0;-1;0
29.12.2018 06:00;20;12;8;Leicht bewoelkt;0;-1;0
29.12.2018 07:00;37;20;17;Leicht bewoelkt;1;-1;0
29.12.2018 08:00;67;45;22;Leicht bewoelkt;1;0;0
29.12.2018 09:00;135;91;44;Leicht bewoelkt;2;1;0
29.12.2018 10:00;172;106;66;Leicht bewoelkt;2;2;0
29.12.2018 11:00;212;126;86;Leicht bewoelkt;3;2;0
29.12.2018 12:00;218;102;116;Leicht bewoelkt;4;3;0
29.12.2018 13:00;237;145;92;Leicht bewoelkt;4;3;0
29.12.2018 14:00;253;113;140;Leicht bewoelkt;4;3;0
29.12.2018 15:00;197;93;104;Leicht bewoelkt;4;3;0
29.12.2018 16:00;180;76;104;Leicht bewoelkt;3;3;0
29.12.2018 17:00;266;105;161;Leicht bewoelkt;3;2;0
29.12.2018 18:00;165;65;100;Leicht bewoelkt;2;1;0
29.12.2018 19:00;141;65;76;Leicht bewoelkt;2;0;0
29.12.2018 20:00;114;54;60;Bewoelkt;2;0;0
29.12.2018 21:00;124;40;84;Bewoelkt;1;-1;0
29.12.2018 22:00;83;38;45;Bewoelkt;2;-1;0
29.12.2018 23:00;45;19;26;Bewoelkt;2;0;0
30.12.2018 00:00;49;13;36;Bewoelkt;3;0;0
30.12.2018 01:00;43;11;32;Bewoelkt;3;0;0
30.12.2018 02:00;19;8;11;Leicht bewoelkt;3;0;0
30.12.2018 03:00;18;7;11;Leicht bewoelkt;4;0;0
30.12.2018 04:00;12;5;7;Leicht bewoelkt;4;0;0
30.12.2018 05:00;10;3;7;Stellenweiser Regenfall;4;0;0
30.12.2018 06:00;15;6;9;Stellenweiser Regenfall;4;0;0
30.12.2018 07:00;13;10;3;Stellenweiser Regenfall;4;0;0
30.12.2018 08:00;21;8;13;Bewoelkt;4;0;0
30.12.2018 09:00;60;38;22;Bewoelkt;4;1;0
30.12.2018 10:00;47;32;15;Bewoelkt;4;1;0
30.12.2018 11:00;101;43;58;Stellenweiser Regenfall;4;1;0
30.12.2018 12:00;87;44;43;Stellenweiser Regenfall;5;2;0
30.12.2018 13:00;133;71;62;Stellenweiser Regenfall;5;2;0
30.12.2018 14:00;156;79;77;Bedeckt;5;2;0
30.12.2018 15:00;122;62;60;Bedeckt;5;3;0
30.12.2018 16:00;173;84;89;Bedeckt;4;3;0
30.12.2018 17:00;131;77;54;Bewoelkt;4;3;0
30.12.2018 18:00;107;53;54;Bewoelkt;4;3;0
30.12.2018 19:00;113;63;50;Bewoelkt;4;3;0
30.12.2018 20:00;64;27;37;Leicht bewoelkt;4;3;0
30.12.2018 21:00;52;19;33;Leicht bewoelkt;3;3;0
30.12.2018 22:00;54;22;32;Leicht bewoelkt;3;2;0
30.12.2018 23:00;35;10;25;Leicht bewoelkt;3;2;0
31.12.2018 00:00;32;11;21;Leicht bewoelkt;3;2;0
31.12.2018 01:00;14;7;7;Leicht bewoelkt;3;2;0
31.12.2018 02:00;10;4;6;Bewoelkt;3;2;0
31.12.2018 03:00;3;1;2;Bewoelkt;3;1;0
31.12.2018 04:00;4;0;4;Bewoelkt;3;1;0
31.12.2018 05:00;18;6;12;Leichter Regenfall;3;1;0
31.12.2018 06:00;23;15;8;Leichter Regenfall;4;1;0
31.12.2018 07:00;36;24;12;Leichter Regenfall;4;1;0
31.12.2018 08:00;77;48;29;Bedeckt;4;1;0
31.12.2018 09:00;143;93;50;Bedeckt;4;2;0
31.12.2018 10:00;206;99;107;Bedeckt;4;2;0
31.12.2018 11:00;241;129;112;Leichter Regenfall;4;3;0
31.12.2018 12:00;204;98;106;Leichter Regenfall;5;3;1
31.12.2018 13:00;212;90;122;Leichter Regenfall;5;4;0
31.12.2018 14:00;163;57;106;Leichter Regenfall;5;4;0
31.12.2018 15:00;145;66;79;Leichter Regenfall;5;5;0
31.12.2018 16:00;119;49;70;Leichter Regenfall;5;5;0
31.12.2018 17:00;139;71;68;Bedeckt;5;4;0
31.12.2018 18:00;181;92;89;Bedeckt;4;4;0
31.12.2018 19:00;197;92;105;Bedeckt;4;4;0
31.12.2018 20:00;96;40;56;Leicht bewoelkt;3;3;0
31.12.2018 21:00;63;29;34;Leicht bewoelkt;3;3;0
31.12.2018 22:00;56;27;29;Leicht bewoelkt;3;3;0
31.12.2018 23:00;73;31;42;Leicht bewoelkt;2;2;0
